"","n_trial","stim_i","oper","O1","O2","RA","Taste","RZ","Fx_zeit","O1_zeit","O2_zeit","RA_zeit","RT_t1","StartPulseTime","cp_jit","RT","trained","subj"
"2","1","106",-0.5,52,13,37,1,968,23717,25214,26611,30902,31870,23269,-400,968,0.5,"/Volumes/Drive/Thesis/new_data/sub8/log_files/sub8_S2_ASTrain.xls"
"3","2","88",-0.5,45,14,41,1,546,42330,43827,45224,50214,50760,23269,300,546,-0.5,"/Volumes/Drive/Thesis/new_data/sub8/log_files/sub8_S2_ASTrain.xls"
"4","3","37",0.5,46,28,64,2,451,62024,63521,64918,69808,70259,23269,200,451,0.5,"/Volumes/Drive/Thesis/new_data/sub8/log_files/sub8_S2_ASTrain.xls"
"5","4","67",-0.5,47,13,24,2,641,81335,82832,84229,88820,89461,23269,-100,641,0.5,"/Volumes/Drive/Thesis/new_data/sub8/log_files/sub8_S2_ASTrain.xls"
"6","5","126",-0.5,86,38,46,1,617,100730,102227,103624,108015,108632,23269,-300,617,-0.5,"/Volumes/Drive/Thesis/new_data/sub8/log_files/sub8_S2_ASTrain.xls"
"7","6","127",-0.5,65,27,48,2,564,120041,121538,122935,127426,127990,23269,-200,564,-0.5,"/Volumes/Drive/Thesis/new_data/sub8/log_files/sub8_S2_ASTrain.xls"
"8","7","9",0.5,24,15,37,2,489,139253,140750,142147,146438,146927,23269,-400,489,0.5,"/Volumes/Drive/Thesis/new_data/sub8/log_files/sub8_S2_ASTrain.xls"
"9","8","32",0.5,47,21,78,1,533,158265,159762,161159,166049,166582,23269,200,533,-0.5,"/Volumes/Drive/Thesis/new_data/sub8/log_files/sub8_S2_ASTrain.xls"
"10","9","36",0.5,57,18,65,1,481,177410,178907,180304,185194,185675,23269,200,481,0.5,"/Volumes/Drive/Thesis/new_data/sub8/log_files/sub8_S2_ASTrain.xls"
"11","10","51",0.5,37,25,72,2,480,196522,198019,199416,204007,204487,23269,-100,480,-0.5,"/Volumes/Drive/Thesis/new_data/sub8/log_files/sub8_S2_ASTrain.xls"
"12","11","92",-0.5,62,21,43,1,501,216116,217613,219010,224000,224501,23269,300,501,-0.5,"/Volumes/Drive/Thesis/new_data/sub8/log_files/sub8_S2_ASTrain.xls"
"13","12","70",-0.5,68,23,35,1,497,235627,237124,238521,243628,244125,23269,400,497,0.5,"/Volumes/Drive/Thesis/new_data/sub8/log_files/sub8_S2_ASTrain.xls"
"14","13","103",-0.5,73,15,68,2,580,255654,257151,258548,263654,264234,23269,400,580,0.5,"/Volumes/Drive/Thesis/new_data/sub8/log_files/sub8_S2_ASTrain.xls"
"15","14","25",0.5,61,18,69,2,612,275764,277261,278658,282949,283561,23269,-400,612,-0.5,"/Volumes/Drive/Thesis/new_data/sub8/log_files/sub8_S2_ASTrain.xls"
"16","15","71",-0.5,67,14,51,2,484,294559,296056,297454,302560,303044,23269,400,484,0.5,"/Volumes/Drive/Thesis/new_data/sub8/log_files/sub8_S2_ASTrain.xls"
"17","16","96",-0.5,56,15,31,1,619,314586,316083,317480,321971,322590,23269,-200,619,-0.5,"/Volumes/Drive/Thesis/new_data/sub8/log_files/sub8_S2_ASTrain.xls"
"18","17","76",-0.5,53,21,34,1,547,333798,335295,336692,341183,341730,23269,-200,547,0.5,"/Volumes/Drive/Thesis/new_data/sub8/log_files/sub8_S2_ASTrain.xls"
"19","18","16",0.5,45,34,89,1,445,353192,354689,356086,360378,360823,23269,-400,445,0.5,"/Volumes/Drive/Thesis/new_data/sub8/log_files/sub8_S2_ASTrain.xls"
"20","19","40",0.5,47,15,64,1,498,371788,373285,374683,379074,379572,23269,-300,498,0.5,"/Volumes/Drive/Thesis/new_data/sub8/log_files/sub8_S2_ASTrain.xls"
"21","20","4",0.5,32,31,65,1,593,391200,392696,394094,398884,399477,23269,100,593,0.5,"/Volumes/Drive/Thesis/new_data/sub8/log_files/sub8_S2_ASTrain.xls"
"22","21","43",0.5,43,19,64,2,474,410295,411792,413189,417580,418054,23269,-300,474,0.5,"/Volumes/Drive/Thesis/new_data/sub8/log_files/sub8_S2_ASTrain.xls"
"23","22","54",0.5,47,18,63,1,546,428991,430488,431885,436476,437022,23269,-100,546,-0.5,"/Volumes/Drive/Thesis/new_data/sub8/log_files/sub8_S2_ASTrain.xls"
"24","23","113",-0.5,82,19,65,2,513,447787,449284,450681,455571,456084,23269,200,513,-0.5,"/Volumes/Drive/Thesis/new_data/sub8/log_files/sub8_S2_ASTrain.xls"
"25","24","18",0.5,32,13,47,1,645,467081,468578,469976,474766,475411,23269,100,645,-0.5,"/Volumes/Drive/Thesis/new_data/sub8/log_files/sub8_S2_ASTrain.xls"
"26","25","120",-0.5,71,35,46,1,536,486676,488173,489570,494061,494597,23269,-200,536,-0.5,"/Volumes/Drive/Thesis/new_data/sub8/log_files/sub8_S2_ASTrain.xls"
"27","26","62",0.5,59,13,74,1,522,505987,507484,508881,513871,514393,23269,300,522,-0.5,"/Volumes/Drive/Thesis/new_data/sub8/log_files/sub8_S2_ASTrain.xls"
"28","27","99",-0.5,83,25,48,2,649,525398,526895,528293,533399,534048,23269,400,649,0.5,"/Volumes/Drive/Thesis/new_data/sub8/log_files/sub8_S2_ASTrain.xls"
"29","28","85",-0.5,65,24,43,2,543,544926,546423,547820,552411,552954,23269,-100,543,-0.5,"/Volumes/Drive/Thesis/new_data/sub8/log_files/sub8_S2_ASTrain.xls"
"30","29","111",-0.5,65,29,38,2,559,564021,565518,566915,571706,572265,23269,100,559,0.5,"/Volumes/Drive/Thesis/new_data/sub8/log_files/sub8_S2_ASTrain.xls"
"31","30","23",0.5,62,14,78,2,568,583316,584813,586210,590602,591170,23269,-300,568,-0.5,"/Volumes/Drive/Thesis/new_data/sub8/log_files/sub8_S2_ASTrain.xls"
"32","31","61",0.5,39,24,61,2,583,602528,604025,605422,610212,610795,23269,100,583,-0.5,"/Volumes/Drive/Thesis/new_data/sub8/log_files/sub8_S2_ASTrain.xls"
"33","32","14",0.5,42,25,69,1,697,622338,623835,625232,630222,630919,23269,300,697,0.5,"/Volumes/Drive/Thesis/new_data/sub8/log_files/sub8_S2_ASTrain.xls"
"34","33","86",-0.5,75,13,64,1,507,676164,677661,679058,684065,684572,676081,300,507,-0.5,"/Volumes/Drive/Thesis/new_data/sub8/log_files/sub8_S2_ASTrain.xls"
"35","34","102",-0.5,84,35,47,1,548,695991,697488,698885,703992,704540,676081,400,548,0.5,"/Volumes/Drive/Thesis/new_data/sub8/log_files/sub8_S2_ASTrain.xls"
"36","35","124",-0.5,71,24,37,1,490,716118,717615,719012,724002,724492,676081,300,490,-0.5,"/Volumes/Drive/Thesis/new_data/sub8/log_files/sub8_S2_ASTrain.xls"
"37","36","20",0.5,51,24,65,1,475,735313,736810,738207,742798,743273,676081,-100,475,-0.5,"/Volumes/Drive/Thesis/new_data/sub8/log_files/sub8_S2_ASTrain.xls"
"38","37","69",-0.5,78,31,45,2,517,754408,755905,757335,761926,762443,676081,-100,517,0.5,"/Volumes/Drive/Thesis/new_data/sub8/log_files/sub8_S2_ASTrain.xls"
"39","38","13",0.5,58,21,69,2,547,773453,774950,776347,780739,781286,676081,-300,547,0.5,"/Volumes/Drive/Thesis/new_data/sub8/log_files/sub8_S2_ASTrain.xls"
"40","39","77",-0.5,86,25,71,2,645,792765,794262,795659,800250,800895,676081,-100,645,0.5,"/Volumes/Drive/Thesis/new_data/sub8/log_files/sub8_S2_ASTrain.xls"
"41","40","26",0.5,31,28,69,1,577,811760,813257,814654,819145,819722,676081,-200,577,-0.5,"/Volumes/Drive/Thesis/new_data/sub8/log_files/sub8_S2_ASTrain.xls"
"42","41","2",0.5,51,13,74,1,557,831254,832751,834149,839039,839596,676081,200,557,0.5,"/Volumes/Drive/Thesis/new_data/sub8/log_files/sub8_S2_ASTrain.xls"
"43","42","105",-0.5,71,24,49,2,673,850965,852462,853859,858250,858923,676081,-300,673,0.5,"/Volumes/Drive/Thesis/new_data/sub8/log_files/sub8_S2_ASTrain.xls"
"44","43","82",-0.5,48,14,32,1,597,869561,871058,872455,876747,877344,676081,-400,597,-0.5,"/Volumes/Drive/Thesis/new_data/sub8/log_files/sub8_S2_ASTrain.xls"
"45","44","121",-0.5,61,24,39,2,473,888773,890270,891667,896058,896531,676081,-300,473,-0.5,"/Volumes/Drive/Thesis/new_data/sub8/log_files/sub8_S2_ASTrain.xls"
"46","45","66",-0.5,86,41,43,1,663,907685,909182,910579,915070,915733,676081,-200,663,0.5,"/Volumes/Drive/Thesis/new_data/sub8/log_files/sub8_S2_ASTrain.xls"
"47","46","44",0.5,43,29,74,1,561,926980,928477,929874,934265,934826,676081,-300,561,0.5,"/Volumes/Drive/Thesis/new_data/sub8/log_files/sub8_S2_ASTrain.xls"
"48","47","1",0.5,51,23,64,2,557,945676,947173,948570,953361,953918,676081,100,557,0.5,"/Volumes/Drive/Thesis/new_data/sub8/log_files/sub8_S2_ASTrain.xls"
"49","48","87",-0.5,86,24,52,2,883,964771,966268,967665,972456,973339,676081,100,883,-0.5,"/Volumes/Drive/Thesis/new_data/sub8/log_files/sub8_S2_ASTrain.xls"
"50","49","24",0.5,43,21,62,1,758,984083,985580,986977,991268,992026,676081,-400,758,-0.5,"/Volumes/Drive/Thesis/new_data/sub8/log_files/sub8_S2_ASTrain.xls"
"51","50","60",0.5,34,29,53,1,479,1003377,1004874,1006272,1011062,1011541,676081,100,479,-0.5,"/Volumes/Drive/Thesis/new_data/sub8/log_files/sub8_S2_ASTrain.xls"
"52","51","63",0.5,47,24,61,2,558,1022972,1024469,1025866,1030357,1030915,676081,-200,558,-0.5,"/Volumes/Drive/Thesis/new_data/sub8/log_files/sub8_S2_ASTrain.xls"
"53","52","45",0.5,48,24,82,2,443,1041867,1043364,1044761,1049252,1049695,676081,-200,443,0.5,"/Volumes/Drive/Thesis/new_data/sub8/log_files/sub8_S2_ASTrain.xls"
"54","53","68",-0.5,46,14,34,1,607,1061062,1062559,1063956,1068946,1069553,676081,300,607,0.5,"/Volumes/Drive/Thesis/new_data/sub8/log_files/sub8_S2_ASTrain.xls"
"55","54","5",0.5,24,12,46,2,492,1080972,1082469,1083867,1088873,1089365,676081,300,492,0.5,"/Volumes/Drive/Thesis/new_data/sub8/log_files/sub8_S2_ASTrain.xls"
"56","55","128",-0.5,75,27,38,1,524,1100384,1101881,1103278,1108168,1108692,676081,200,524,-0.5,"/Volumes/Drive/Thesis/new_data/sub8/log_files/sub8_S2_ASTrain.xls"
"57","56","28",0.5,52,16,78,1,590,1120194,1121691,1123088,1128195,1128785,676081,400,590,-0.5,"/Volumes/Drive/Thesis/new_data/sub8/log_files/sub8_S2_ASTrain.xls"
"58","57","116",-0.5,51,19,42,1,478,1140021,1141518,1142915,1147806,1148284,676081,200,478,-0.5,"/Volumes/Drive/Thesis/new_data/sub8/log_files/sub8_S2_ASTrain.xls"
"59","58","93",-0.5,68,37,21,2,503,1159216,1160713,1162110,1167217,1167720,676081,400,503,-0.5,"/Volumes/Drive/Thesis/new_data/sub8/log_files/sub8_S2_ASTrain.xls"
"60","59","50",0.5,49,26,73,1,538,1179043,1180540,1181937,1186728,1187266,676081,100,538,-0.5,"/Volumes/Drive/Thesis/new_data/sub8/log_files/sub8_S2_ASTrain.xls"
"61","60","104",-0.5,51,16,25,1,1518,1198155,1199652,1201049,1205341,1206859,676081,-400,1518,0.5,"/Volumes/Drive/Thesis/new_data/sub8/log_files/sub8_S2_ASTrain.xls"
"62","61","48",0.5,49,24,71,1,671,1216668,1218165,1219562,1224453,1225124,676081,200,671,0.5,"/Volumes/Drive/Thesis/new_data/sub8/log_files/sub8_S2_ASTrain.xls"
"63","62","55",0.5,35,28,73,2,562,1236578,1238075,1239473,1243764,1244326,676081,-400,562,-0.5,"/Volumes/Drive/Thesis/new_data/sub8/log_files/sub8_S2_ASTrain.xls"
"64","63","34",0.5,37,28,67,1,653,1255374,1256871,1258268,1262859,1263512,676081,-100,653,0.5,"/Volumes/Drive/Thesis/new_data/sub8/log_files/sub8_S2_ASTrain.xls"
"65","64","100",-0.5,74,35,49,1,512,1274187,1275684,1277081,1282187,1282699,676081,400,512,0.5,"/Volumes/Drive/Thesis/new_data/sub8/log_files/sub8_S2_ASTrain.xls"
"66","65","38",0.5,39,25,74,1,513,1327064,1328561,1329959,1334949,1335462,1326943,300,513,0.5,"/Volumes/Drive/Thesis/new_data/sub8/log_files/sub8_S2_ASTrain.xls"
"67","66","112",-0.5,57,18,49,1,452,1346559,1348056,1349453,1354243,1354695,1326943,100,452,0.5,"/Volumes/Drive/Thesis/new_data/sub8/log_files/sub8_S2_ASTrain.xls"
"68","67","56",0.5,58,17,65,1,474,1366070,1367567,1368964,1373455,1373929,1326943,-200,474,-0.5,"/Volumes/Drive/Thesis/new_data/sub8/log_files/sub8_S2_ASTrain.xls"
"69","68","19",0.5,34,23,67,2,483,1385381,1386878,1388275,1393382,1393865,1326943,400,483,-0.5,"/Volumes/Drive/Thesis/new_data/sub8/log_files/sub8_S2_ASTrain.xls"
"70","69","73",-0.5,83,51,34,2,481,1405508,1407005,1408402,1412993,1413474,1326943,-100,481,0.5,"/Volumes/Drive/Thesis/new_data/sub8/log_files/sub8_S2_ASTrain.xls"
"71","70","84",-0.5,89,41,46,1,539,1424320,1425817,1427214,1431606,1432145,1326943,-300,539,-0.5,"/Volumes/Drive/Thesis/new_data/sub8/log_files/sub8_S2_ASTrain.xls"
"72","71","74",-0.5,63,12,41,1,629,1443033,1444530,1445927,1450218,1450847,1326943,-400,629,0.5,"/Volumes/Drive/Thesis/new_data/sub8/log_files/sub8_S2_ASTrain.xls"
"73","73","107",-0.5,61,14,57,2,720,1480924,1482421,1483818,1488109,1488829,1326943,-400,720,0.5,"/Volumes/Drive/Thesis/new_data/sub8/log_files/sub8_S2_ASTrain.xls"
"74","74","83",-0.5,48,23,23,2,524,1500135,1501632,1503030,1507820,1508344,1326943,100,524,-0.5,"/Volumes/Drive/Thesis/new_data/sub8/log_files/sub8_S2_ASTrain.xls"
"75","75","8",0.5,24,13,47,1,553,1519430,1520927,1522324,1527431,1527984,1326943,400,553,0.5,"/Volumes/Drive/Thesis/new_data/sub8/log_files/sub8_S2_ASTrain.xls"
"76","76","7",0.5,42,34,78,2,525,1539457,1540954,1542351,1547458,1547983,1326943,400,525,0.5,"/Volumes/Drive/Thesis/new_data/sub8/log_files/sub8_S2_ASTrain.xls"
"77","77","59",0.5,45,26,81,2,638,1559267,1560764,1562162,1566453,1567091,1326943,-400,638,-0.5,"/Volumes/Drive/Thesis/new_data/sub8/log_files/sub8_S2_ASTrain.xls"
"78","78","108",-0.5,72,23,39,1,570,1577980,1579477,1580874,1585864,1586434,1326943,300,570,0.5,"/Volumes/Drive/Thesis/new_data/sub8/log_files/sub8_S2_ASTrain.xls"
"79","79","46",0.5,29,14,41,1,429,1597691,1599188,1600585,1605176,1605605,1326943,-100,429,0.5,"/Volumes/Drive/Thesis/new_data/sub8/log_files/sub8_S2_ASTrain.xls"
"80","80","89",-0.5,54,12,32,2,491,1616586,1618083,1619480,1623972,1624463,1326943,-200,491,-0.5,"/Volumes/Drive/Thesis/new_data/sub8/log_files/sub8_S2_ASTrain.xls"
"81","81","27",0.5,41,17,56,2,790,1635881,1637378,1638775,1643266,1644056,1326943,-200,790,-0.5,"/Volumes/Drive/Thesis/new_data/sub8/log_files/sub8_S2_ASTrain.xls"
"82","82","12",0.5,62,16,68,1,606,1655292,1656789,1658187,1663293,1663899,1326943,400,606,0.5,"/Volumes/Drive/Thesis/new_data/sub8/log_files/sub8_S2_ASTrain.xls"
"83","83","90",-0.5,74,43,41,1,544,1675419,1676916,1678313,1682604,1683148,1326943,-400,544,-0.5,"/Volumes/Drive/Thesis/new_data/sub8/log_files/sub8_S2_ASTrain.xls"
"84","84","123",-0.5,62,13,59,2,443,1694614,1696111,1697508,1702298,1702741,1326943,100,443,-0.5,"/Volumes/Drive/Thesis/new_data/sub8/log_files/sub8_S2_ASTrain.xls"
"85","85","122",-0.5,52,14,36,1,496,1714108,1715605,1717002,1722009,1722505,1326943,300,496,-0.5,"/Volumes/Drive/Thesis/new_data/sub8/log_files/sub8_S2_ASTrain.xls"
"86","86","109",-0.5,75,26,47,2,509,1733320,1734817,1736214,1740605,1741114,1326943,-300,509,0.5,"/Volumes/Drive/Thesis/new_data/sub8/log_files/sub8_S2_ASTrain.xls"
"87","87","72",-0.5,79,21,68,1,571,1751916,1753413,1754810,1759401,1759972,1326943,-100,571,0.5,"/Volumes/Drive/Thesis/new_data/sub8/log_files/sub8_S2_ASTrain.xls"
"88","88","21",0.5,42,34,74,2,473,1771527,1773024,1774421,1779311,1779784,1326943,200,473,-0.5,"/Volumes/Drive/Thesis/new_data/sub8/log_files/sub8_S2_ASTrain.xls"
"89","89","52",0.5,46,27,63,1,447,1790739,1792236,1793633,1798523,1798970,1326943,200,447,-0.5,"/Volumes/Drive/Thesis/new_data/sub8/log_files/sub8_S2_ASTrain.xls"
"90","90","118",-0.5,73,27,48,1,855,1810133,1811630,1813027,1817818,1818673,1326943,100,855,-0.5,"/Volumes/Drive/Thesis/new_data/sub8/log_files/sub8_S2_ASTrain.xls"
"91","91","11",0.5,61,17,76,2,598,1829345,1830842,1832239,1836730,1837328,1326943,-200,598,0.5,"/Volumes/Drive/Thesis/new_data/sub8/log_files/sub8_S2_ASTrain.xls"
"92","92","78",-0.5,79,36,53,1,623,1848257,1849754,1851151,1856141,1856764,1326943,300,623,0.5,"/Volumes/Drive/Thesis/new_data/sub8/log_files/sub8_S2_ASTrain.xls"
"93","93","39",0.5,48,27,73,2,476,1867768,1869265,1870662,1875553,1876029,1326943,200,476,0.5,"/Volumes/Drive/Thesis/new_data/sub8/log_files/sub8_S2_ASTrain.xls"
"94","94","35",0.5,36,17,63,2,577,1887462,1888959,1890356,1894748,1895325,1326943,-300,577,0.5,"/Volumes/Drive/Thesis/new_data/sub8/log_files/sub8_S2_ASTrain.xls"
"95","95","30",0.5,45,34,69,1,572,1906158,1907655,1909052,1913643,1914215,1326943,-100,572,-0.5,"/Volumes/Drive/Thesis/new_data/sub8/log_files/sub8_S2_ASTrain.xls"
"96","96","119",-0.5,54,17,27,2,582,1924971,1926468,1927865,1932788,1933370,1326943,200,582,-0.5,"/Volumes/Drive/Thesis/new_data/sub8/log_files/sub8_S2_ASTrain.xls"
"97","97","29",0.5,45,14,57,2,493,1976019,1977516,1978913,1983703,1984196,1975905,100,493,-0.5,"/Volumes/Drive/Thesis/new_data/sub8/log_files/sub8_S2_ASTrain.xls"
"98","98","58",0.5,54,18,74,1,575,1995513,1997010,1998407,2003198,2003773,1975905,100,575,-0.5,"/Volumes/Drive/Thesis/new_data/sub8/log_files/sub8_S2_ASTrain.xls"
"99","99","15",0.5,47,31,76,2,516,2014708,2016205,2017602,2022709,2023225,1975905,400,516,0.5,"/Volumes/Drive/Thesis/new_data/sub8/log_files/sub8_S2_ASTrain.xls"
"100","100","42",0.5,52,19,61,1,832,2034834,2036331,2037729,2042220,2043052,1975905,-200,832,0.5,"/Volumes/Drive/Thesis/new_data/sub8/log_files/sub8_S2_ASTrain.xls"
"101","101","53",0.5,58,16,76,2,601,2053847,2055344,2056741,2061731,2062332,1975905,300,601,-0.5,"/Volumes/Drive/Thesis/new_data/sub8/log_files/sub8_S2_ASTrain.xls"
"102","102","64",0.5,38,14,62,1,562,2073557,2075054,2076451,2081441,2082003,1975905,300,562,-0.5,"/Volumes/Drive/Thesis/new_data/sub8/log_files/sub8_S2_ASTrain.xls"
"103","103","33",0.5,58,16,72,2,694,2092852,2094349,2095746,2100636,2101330,1975905,200,694,0.5,"/Volumes/Drive/Thesis/new_data/sub8/log_files/sub8_S2_ASTrain.xls"
"104","104","101",-0.5,64,18,48,2,516,2112147,2113644,2115041,2120048,2120564,1975905,300,516,0.5,"/Volumes/Drive/Thesis/new_data/sub8/log_files/sub8_S2_ASTrain.xls"
"105","105","117",-0.5,72,29,41,2,1000,2131674,2133171,2134569,2138860,2139860,1975905,-400,1000,-0.5,"/Volumes/Drive/Thesis/new_data/sub8/log_files/sub8_S2_ASTrain.xls"
"106","106","94",-0.5,86,35,61,1,580,2150387,2151884,2153281,2158388,2158968,1975905,400,580,-0.5,"/Volumes/Drive/Thesis/new_data/sub8/log_files/sub8_S2_ASTrain.xls"
"107","107","80",-0.5,59,18,31,1,596,2169699,2171196,2172593,2177184,2177780,1975905,-100,596,0.5,"/Volumes/Drive/Thesis/new_data/sub8/log_files/sub8_S2_ASTrain.xls"
"108","108","3",0.5,52,24,74,2,881,2188694,2190191,2191588,2196695,2197576,1975905,400,881,0.5,"/Volumes/Drive/Thesis/new_data/sub8/log_files/sub8_S2_ASTrain.xls"
"109","109","95",-0.5,68,15,51,2,613,2208521,2210018,2211415,2215806,2216419,1975905,-300,613,-0.5,"/Volumes/Drive/Thesis/new_data/sub8/log_files/sub8_S2_ASTrain.xls"
"110","110","97",-0.5,51,19,34,2,650,2227117,2228614,2230011,2234502,2235152,1975905,-200,650,0.5,"/Volumes/Drive/Thesis/new_data/sub8/log_files/sub8_S2_ASTrain.xls"
"111","111","22",0.5,31,23,56,1,950,2246528,2248025,2249423,2254014,2254964,1975905,-100,950,-0.5,"/Volumes/Drive/Thesis/new_data/sub8/log_files/sub8_S2_ASTrain.xls"
"112","112","17",0.5,62,14,78,2,619,2265940,2267437,2268834,2273125,2273744,1975905,-400,619,-0.5,"/Volumes/Drive/Thesis/new_data/sub8/log_files/sub8_S2_ASTrain.xls"
"113","113","81",-0.5,76,24,54,1,1052,2284553,2286050,2287447,2291738,2292790,1975905,-400,1052,-0.5,"/Volumes/Drive/Thesis/new_data/sub8/log_files/sub8_S2_ASTrain.xls"
"114","114","65",-0.5,48,12,34,2,477,2303066,2304563,2305993,2310484,2310961,1975905,-200,477,0.5,"/Volumes/Drive/Thesis/new_data/sub8/log_files/sub8_S2_ASTrain.xls"
"115","115","6",0.5,52,13,67,1,656,2322394,2323891,2325288,2329679,2330335,1975905,-300,656,0.5,"/Volumes/Drive/Thesis/new_data/sub8/log_files/sub8_S2_ASTrain.xls"
"116","116","47",0.5,49,23,62,2,484,2341505,2343002,2344400,2348991,2349475,1975905,-100,484,0.5,"/Volumes/Drive/Thesis/new_data/sub8/log_files/sub8_S2_ASTrain.xls"
"117","117","31",0.5,67,12,69,2,493,2360617,2362114,2363512,2368402,2368895,1975905,200,493,-0.5,"/Volumes/Drive/Thesis/new_data/sub8/log_files/sub8_S2_ASTrain.xls"
"118","118","75",-0.5,84,52,42,2,460,2379812,2381309,2382707,2387497,2387957,1975905,100,460,0.5,"/Volumes/Drive/Thesis/new_data/sub8/log_files/sub8_S2_ASTrain.xls"
"119","120","91",-0.5,74,42,42,2,451,2419001,2420498,2421895,2426785,2427236,1975905,200,451,-0.5,"/Volumes/Drive/Thesis/new_data/sub8/log_files/sub8_S2_ASTrain.xls"
"120","121","10",0.5,42,37,69,1,510,2438412,2439909,2441306,2445897,2446407,1975905,-100,510,0.5,"/Volumes/Drive/Thesis/new_data/sub8/log_files/sub8_S2_ASTrain.xls"
"121","122","49",0.5,39,17,58,2,581,2457906,2459403,2460801,2465591,2466172,1975905,100,581,-0.5,"/Volumes/Drive/Thesis/new_data/sub8/log_files/sub8_S2_ASTrain.xls"
"122","123","41",0.5,54,17,81,2,425,2477517,2479014,2480411,2484902,2485327,1975905,-200,425,0.5,"/Volumes/Drive/Thesis/new_data/sub8/log_files/sub8_S2_ASTrain.xls"
"123","124","79",-0.5,49,17,34,2,527,2496213,2497710,2499107,2503399,2503926,1975905,-400,527,0.5,"/Volumes/Drive/Thesis/new_data/sub8/log_files/sub8_S2_ASTrain.xls"
"124","125","125",-0.5,75,38,39,2,523,2515308,2516805,2518203,2523193,2523716,1975905,300,523,-0.5,"/Volumes/Drive/Thesis/new_data/sub8/log_files/sub8_S2_ASTrain.xls"
"125","126","114",-0.5,62,28,32,1,927,2535318,2536816,2538213,2543319,2544246,1975905,400,927,-0.5,"/Volumes/Drive/Thesis/new_data/sub8/log_files/sub8_S2_ASTrain.xls"
"126","127","110",-0.5,86,18,58,1,559,2554730,2556227,2557624,2562514,2563073,1975905,200,559,0.5,"/Volumes/Drive/Thesis/new_data/sub8/log_files/sub8_S2_ASTrain.xls"
"127","128","115",-0.5,64,25,29,2,795,2574524,2576021,2577418,2581809,2582604,1975905,-300,795,-0.5,"/Volumes/Drive/Thesis/new_data/sub8/log_files/sub8_S2_ASTrain.xls"
"128","1","95",-0.5,68,15,51,2,979,22935,24432,25830,30620,31599,22898,100,979,0.5,"/Volumes/Drive/Thesis/new_data/sub9/log_files/sub9_S2_ASTrain.xls"
"129","3","111",-0.5,65,29,38,2,853,61625,63122,64520,69510,70363,22898,300,853,-0.5,"/Volumes/Drive/Thesis/new_data/sub9/log_files/sub9_S2_ASTrain.xls"
"130","4","1",0.5,51,23,64,2,483,81336,82833,84230,89237,89720,22898,300,483,-0.5,"/Volumes/Drive/Thesis/new_data/sub9/log_files/sub9_S2_ASTrain.xls"
"131","5","42",0.5,52,19,61,1,625,100864,102361,103758,108549,109174,22898,100,625,-0.5,"/Volumes/Drive/Thesis/new_data/sub9/log_files/sub9_S2_ASTrain.xls"
"132","6","44",0.5,43,29,74,1,688,120359,121856,123253,128360,129048,22898,400,688,-0.5,"/Volumes/Drive/Thesis/new_data/sub9/log_files/sub9_S2_ASTrain.xls"
"133","7","79",-0.5,49,17,34,2,899,140186,141683,143080,147571,148470,22898,-200,899,-0.5,"/Volumes/Drive/Thesis/new_data/sub9/log_files/sub9_S2_ASTrain.xls"
"134","8","88",-0.5,45,14,41,1,573,159398,160895,162292,166584,167157,22898,-400,573,0.5,"/Volumes/Drive/Thesis/new_data/sub9/log_files/sub9_S2_ASTrain.xls"
"135","9","19",0.5,34,23,67,1,746,178610,180107,181504,186394,187140,22898,200,746,0.5,"/Volumes/Drive/Thesis/new_data/sub9/log_files/sub9_S2_ASTrain.xls"
"136","10","51",0.5,37,25,72,2,1147,198304,199801,201198,206305,207452,22898,400,1147,0.5,"/Volumes/Drive/Thesis/new_data/sub9/log_files/sub9_S2_ASTrain.xls"
"137","11","14",0.5,48,21,71,1,735,218231,219728,221126,226232,226967,22898,400,735,-0.5,"/Volumes/Drive/Thesis/new_data/sub9/log_files/sub9_S2_ASTrain.xls"
"138","12","105",-0.5,71,24,49,2,1394,237759,239256,240653,245760,247154,22898,400,1394,-0.5,"/Volumes/Drive/Thesis/new_data/sub9/log_files/sub9_S2_ASTrain.xls"
"139","13","17",0.5,62,14,78,2,619,257270,258768,260165,264456,265075,22898,-400,619,0.5,"/Volumes/Drive/Thesis/new_data/sub9/log_files/sub9_S2_ASTrain.xls"
"140","14","48",0.5,49,24,71,1,613,276083,277580,278977,283868,284481,22898,200,613,-0.5,"/Volumes/Drive/Thesis/new_data/sub9/log_files/sub9_S2_ASTrain.xls"
"141","15","76",-0.5,53,21,34,1,610,295877,297374,298772,303761,304371,22898,300,610,-0.5,"/Volumes/Drive/Thesis/new_data/sub9/log_files/sub9_S2_ASTrain.xls"
"142","16","58",0.5,54,18,74,2,1453,315072,316570,317967,322757,324210,22898,100,1453,0.5,"/Volumes/Drive/Thesis/new_data/sub9/log_files/sub9_S2_ASTrain.xls"
"143","17","28",0.5,52,16,78,1,835,334883,336380,337777,342269,343104,22898,-200,835,0.5,"/Volumes/Drive/Thesis/new_data/sub9/log_files/sub9_S2_ASTrain.xls"
"144","18","62",0.5,59,13,74,1,843,354295,355792,357189,361979,362822,22898,100,843,0.5,"/Volumes/Drive/Thesis/new_data/sub9/log_files/sub9_S2_ASTrain.xls"
"145","19","109",-0.5,75,26,47,2,1009,373290,374787,376185,380609,381618,22898,-300,1009,-0.5,"/Volumes/Drive/Thesis/new_data/sub9/log_files/sub9_S2_ASTrain.xls"
"146","20","9",0.5,24,15,37,2,622,392120,393617,395014,399605,400227,22898,-100,622,-0.5,"/Volumes/Drive/Thesis/new_data/sub9/log_files/sub9_S2_ASTrain.xls"
"147","21","114",-0.5,82,28,52,1,704,411631,413128,414525,419116,419820,22898,-100,704,0.5,"/Volumes/Drive/Thesis/new_data/sub9/log_files/sub9_S2_ASTrain.xls"
"148","22","45",0.5,48,24,82,2,825,430543,432040,433438,437729,438554,22898,-400,825,-0.5,"/Volumes/Drive/Thesis/new_data/sub9/log_files/sub9_S2_ASTrain.xls"
"149","23","91",-0.5,74,42,42,1,981,449140,450637,452034,456525,457506,22898,-200,981,0.5,"/Volumes/Drive/Thesis/new_data/sub9/log_files/sub9_S2_ASTrain.xls"
"150","24","63",0.5,47,24,61,2,880,467953,469450,470847,475438,476318,22898,-100,880,0.5,"/Volumes/Drive/Thesis/new_data/sub9/log_files/sub9_S2_ASTrain.xls"
"151","25","69",-0.5,78,31,45,2,755,486765,488262,489660,494250,495005,22898,-100,755,-0.5,"/Volumes/Drive/Thesis/new_data/sub9/log_files/sub9_S2_ASTrain.xls"
"152","26","8",0.5,24,13,47,1,579,505578,507075,508472,513363,513942,22898,200,579,-0.5,"/Volumes/Drive/Thesis/new_data/sub9/log_files/sub9_S2_ASTrain.xls"
"153","27","123",-0.5,62,13,59,2,751,524873,526370,527767,532159,532910,22898,-300,751,0.5,"/Volumes/Drive/Thesis/new_data/sub9/log_files/sub9_S2_ASTrain.xls"
"154","28","116",-0.5,53,17,46,1,857,544085,545582,546979,551271,552128,22898,-400,857,0.5,"/Volumes/Drive/Thesis/new_data/sub9/log_files/sub9_S2_ASTrain.xls"
"155","29","73",-0.5,83,51,34,2,630,563180,564677,566075,570466,571096,22898,-300,630,-0.5,"/Volumes/Drive/Thesis/new_data/sub9/log_files/sub9_S2_ASTrain.xls"
"156","30","26",0.5,31,28,69,1,866,581877,583374,584771,589761,590627,22898,300,866,0.5,"/Volumes/Drive/Thesis/new_data/sub9/log_files/sub9_S2_ASTrain.xls"
"157","31","98",-0.5,62,28,32,1,713,601887,603384,604781,609272,609985,22898,-200,713,-0.5,"/Volumes/Drive/Thesis/new_data/sub9/log_files/sub9_S2_ASTrain.xls"
"158","32","120",-0.5,71,35,46,1,881,621382,622879,624276,629166,630047,22898,200,881,0.5,"/Volumes/Drive/Thesis/new_data/sub9/log_files/sub9_S2_ASTrain.xls"
"159","33","72",-0.5,79,21,68,1,904,684706,686203,687600,692391,693295,684688,100,904,-0.5,"/Volumes/Drive/Thesis/new_data/sub9/log_files/sub9_S2_ASTrain.xls"
"160","34","96",-0.5,56,15,31,1,503,703718,705215,706613,711104,711607,684688,-200,503,0.5,"/Volumes/Drive/Thesis/new_data/sub9/log_files/sub9_S2_ASTrain.xls"
"161","37","84",-0.5,89,41,46,1,941,760323,761820,763217,767508,768449,684688,-400,941,0.5,"/Volumes/Drive/Thesis/new_data/sub9/log_files/sub9_S2_ASTrain.xls"
"162","38","93",-0.5,68,37,21,2,1265,779618,781115,782512,787402,788667,684688,200,1265,0.5,"/Volumes/Drive/Thesis/new_data/sub9/log_files/sub9_S2_ASTrain.xls"
"163","39","16",0.5,45,34,89,1,730,799229,800726,802123,806514,807244,684688,-300,730,-0.5,"/Volumes/Drive/Thesis/new_data/sub9/log_files/sub9_S2_ASTrain.xls"
"164","40","118",-0.5,73,27,48,1,1429,818524,820021,821418,826408,827837,684688,300,1429,0.5,"/Volumes/Drive/Thesis/new_data/sub9/log_files/sub9_S2_ASTrain.xls"
"165","41","101",-0.5,64,18,48,2,860,837836,839333,840730,845321,846181,684688,-100,860,-0.5,"/Volumes/Drive/Thesis/new_data/sub9/log_files/sub9_S2_ASTrain.xls"
"166","42","18",0.5,32,13,47,1,645,856831,858328,859725,864832,865477,684688,400,645,0.5,"/Volumes/Drive/Thesis/new_data/sub9/log_files/sub9_S2_ASTrain.xls"
"167","43","78",-0.5,79,36,53,1,602,876642,878139,879536,884327,884929,684688,100,602,-0.5,"/Volumes/Drive/Thesis/new_data/sub9/log_files/sub9_S2_ASTrain.xls"
"168","44","106",-0.5,52,13,37,1,690,895754,897251,898648,903239,903929,684688,-100,690,-0.5,"/Volumes/Drive/Thesis/new_data/sub9/log_files/sub9_S2_ASTrain.xls"
"169","45","11",0.5,61,17,76,2,646,915265,916762,918160,923266,923912,684688,400,646,-0.5,"/Volumes/Drive/Thesis/new_data/sub9/log_files/sub9_S2_ASTrain.xls"
"170","46","97",-0.5,51,19,34,2,584,934777,936274,937671,942062,942646,684688,-300,584,-0.5,"/Volumes/Drive/Thesis/new_data/sub9/log_files/sub9_S2_ASTrain.xls"
"171","47","121",-0.5,61,24,39,2,1298,953989,955486,956883,961873,963171,684688,300,1298,0.5,"/Volumes/Drive/Thesis/new_data/sub9/log_files/sub9_S2_ASTrain.xls"
"172","48","13",0.5,58,21,69,2,1007,973400,974897,976294,981185,982192,684688,200,1007,-0.5,"/Volumes/Drive/Thesis/new_data/sub9/log_files/sub9_S2_ASTrain.xls"
"173","49","40",0.5,67,15,84,2,1600,993294,994791,996188,1000779,1002379,684688,-100,1600,-0.5,"/Volumes/Drive/Thesis/new_data/sub9/log_files/sub9_S2_ASTrain.xls"
"174","50","124",-0.5,72,24,38,2,1284,1012705,1014202,1015600,1019891,1021175,684688,-400,1284,0.5,"/Volumes/Drive/Thesis/new_data/sub9/log_files/sub9_S2_ASTrain.xls"
"175","51","53",0.5,57,16,75,1,1272,1031917,1033414,1034812,1039402,1040674,684688,-100,1272,0.5,"/Volumes/Drive/Thesis/new_data/sub9/log_files/sub9_S2_ASTrain.xls"
"176","52","65",-0.5,68,12,54,2,919,1051329,1052826,1054223,1058614,1059533,684688,-300,919,-0.5,"/Volumes/Drive/Thesis/new_data/sub9/log_files/sub9_S2_ASTrain.xls"
"177","53","50",0.5,49,25,72,1,672,1070740,1072237,1073635,1078126,1078798,684688,-200,672,0.5,"/Volumes/Drive/Thesis/new_data/sub9/log_files/sub9_S2_ASTrain.xls"
"178","54","35",0.5,36,17,63,2,1641,1089753,1091250,1092647,1097437,1099078,684688,100,1641,-0.5,"/Volumes/Drive/Thesis/new_data/sub9/log_files/sub9_S2_ASTrain.xls"
"179","55","34",0.5,37,28,67,1,1034,1109447,1110944,1112341,1117231,1118265,684688,200,1034,-0.5,"/Volumes/Drive/Thesis/new_data/sub9/log_files/sub9_S2_ASTrain.xls"
"180","56","27",0.5,41,17,56,2,906,1129058,1130555,1131952,1136843,1137749,684688,200,906,0.5,"/Volumes/Drive/Thesis/new_data/sub9/log_files/sub9_S2_ASTrain.xls"
"181","57","33",0.5,58,16,72,2,757,1148153,1149650,1151048,1156038,1156795,684688,300,757,-0.5,"/Volumes/Drive/Thesis/new_data/sub9/log_files/sub9_S2_ASTrain.xls"
"182","58","70",-0.5,68,23,35,1,677,1167648,1169145,1170542,1175649,1176326,684688,400,677,-0.5,"/Volumes/Drive/Thesis/new_data/sub9/log_files/sub9_S2_ASTrain.xls"
"183","60","22",0.5,31,23,56,1,747,1206255,1207752,1209149,1213640,1214387,684688,-200,747,0.5,"/Volumes/Drive/Thesis/new_data/sub9/log_files/sub9_S2_ASTrain.xls"
"184","61","52",0.5,46,27,63,2,1433,1225167,1226664,1228062,1232453,1233886,684688,-300,1433,0.5,"/Volumes/Drive/Thesis/new_data/sub9/log_files/sub9_S2_ASTrain.xls"
"185","62","104",-0.5,51,16,25,1,987,1244279,1245776,1247174,1252164,1253151,684688,300,987,-0.5,"/Volumes/Drive/Thesis/new_data/sub9/log_files/sub9_S2_ASTrain.xls"
"186","63","30",0.5,46,32,68,2,1019,1264290,1265787,1267184,1271475,1272494,684688,-400,1019,0.5,"/Volumes/Drive/Thesis/new_data/sub9/log_files/sub9_S2_ASTrain.xls"
"187","64","7",0.5,42,34,78,2,656,1283102,1284599,1285997,1291103,1291759,684688,400,656,-0.5,"/Volumes/Drive/Thesis/new_data/sub9/log_files/sub9_S2_ASTrain.xls"
"188","65","110",-0.5,86,18,58,2,1315,1341453,1342950,1344348,1348739,1350054,1341262,-300,1315,-0.5,"/Volumes/Drive/Thesis/new_data/sub9/log_files/sub9_S2_ASTrain.xls"
"189","66","89",-0.5,54,12,32,2,938,1360665,1362162,1363559,1368350,1369288,1341262,100,938,0.5,"/Volumes/Drive/Thesis/new_data/sub9/log_files/sub9_S2_ASTrain.xls"
"190","67","24",0.5,61,23,82,1,737,1379678,1381175,1382572,1386863,1387600,1341262,-400,737,0.5,"/Volumes/Drive/Thesis/new_data/sub9/log_files/sub9_S2_ASTrain.xls"
"191","68","108",-0.5,72,23,39,1,590,1398291,1399788,1401185,1406291,1406881,1341262,400,590,-0.5,"/Volumes/Drive/Thesis/new_data/sub9/log_files/sub9_S2_ASTrain.xls"
"192","71","77",-0.5,86,25,71,2,624,1457523,1459020,1460417,1465208,1465832,1341262,100,624,-0.5,"/Volumes/Drive/Thesis/new_data/sub9/log_files/sub9_S2_ASTrain.xls"
"193","72","61",0.5,39,24,61,2,750,1477018,1478515,1479912,1484503,1485253,1341262,-100,750,0.5,"/Volumes/Drive/Thesis/new_data/sub9/log_files/sub9_S2_ASTrain.xls"
"194","73","3",0.5,52,24,74,2,695,1496429,1497926,1499324,1504214,1504909,1341262,200,695,-0.5,"/Volumes/Drive/Thesis/new_data/sub9/log_files/sub9_S2_ASTrain.xls"
"195","74","113",-0.5,82,19,65,2,746,1516223,1517720,1519118,1523709,1524455,1341262,-100,746,0.5,"/Volumes/Drive/Thesis/new_data/sub9/log_files/sub9_S2_ASTrain.xls"
"196","75","41",0.5,54,17,81,2,648,1535152,1536650,1538047,1542837,1543485,1341262,100,648,-0.5,"/Volumes/Drive/Thesis/new_data/sub9/log_files/sub9_S2_ASTrain.xls"
"197","76","54",0.5,47,35,80,1,783,1554863,1556360,1557758,1562249,1563032,1341262,-200,783,0.5,"/Volumes/Drive/Thesis/new_data/sub9/log_files/sub9_S2_ASTrain.xls"
"198","77","43",0.5,43,19,64,2,773,1573576,1575073,1576471,1581461,1582234,1341262,300,773,-0.5,"/Volumes/Drive/Thesis/new_data/sub9/log_files/sub9_S2_ASTrain.xls"
"199","78","71",-0.5,67,14,51,2,707,1592971,1594468,1595865,1600855,1601562,1341262,300,707,-0.5,"/Volumes/Drive/Thesis/new_data/sub9/log_files/sub9_S2_ASTrain.xls"
"200","79","100",-0.5,74,35,49,1,1188,1612166,1613663,1615061,1619951,1621139,1341262,200,1188,-0.5,"/Volumes/Drive/Thesis/new_data/sub9/log_files/sub9_S2_ASTrain.xls"
"201","80","117",-0.5,72,29,41,1,1347,1631478,1632975,1634372,1638963,1640310,1341262,-100,1347,0.5,"/Volumes/Drive/Thesis/new_data/sub9/log_files/sub9_S2_ASTrain.xls"
"202","82","80",-0.5,59,18,31,1,694,1669386,1670883,1672280,1677271,1677965,1341262,300,694,-0.5,"/Volumes/Drive/Thesis/new_data/sub9/log_files/sub9_S2_ASTrain.xls"
"203","83","21",0.5,41,34,73,1,1076,1688781,1690278,1691675,1695967,1697043,1341262,-400,1076,0.5,"/Volumes/Drive/Thesis/new_data/sub9/log_files/sub9_S2_ASTrain.xls"
"204","84","119",-0.5,54,17,27,2,1262,1708076,1709573,1710970,1716077,1717339,1341262,400,1262,0.5,"/Volumes/Drive/Thesis/new_data/sub9/log_files/sub9_S2_ASTrain.xls"
"205","85","6",0.5,52,13,67,1,766,1728186,1729683,1731081,1735572,1736338,1341262,-200,766,-0.5,"/Volumes/Drive/Thesis/new_data/sub9/log_files/sub9_S2_ASTrain.xls"
"206","86","31",0.5,67,12,69,2,1308,1747199,1748696,1750093,1754983,1756291,1341262,200,1308,0.5,"/Volumes/Drive/Thesis/new_data/sub9/log_files/sub9_S2_ASTrain.xls"
"207","87","122",-0.5,52,14,36,1,787,1766593,1768090,1769488,1774378,1775165,1341262,200,787,0.5,"/Volumes/Drive/Thesis/new_data/sub9/log_files/sub9_S2_ASTrain.xls"
"208","88","15",0.5,47,31,76,2,627,1786005,1787502,1788899,1794006,1794633,1341262,400,627,-0.5,"/Volumes/Drive/Thesis/new_data/sub9/log_files/sub9_S2_ASTrain.xls"
"209","89","81",-0.5,76,24,54,1,1156,1805317,1806814,1808211,1812602,1813758,1341262,-300,1156,0.5,"/Volumes/Drive/Thesis/new_data/sub9/log_files/sub9_S2_ASTrain.xls"
"210","90","67",-0.5,47,13,24,2,1101,1824412,1825909,1827306,1831797,1832898,1341262,-200,1101,-0.5,"/Volumes/Drive/Thesis/new_data/sub9/log_files/sub9_S2_ASTrain.xls"
"211","91","23",0.5,64,12,78,2,541,1843923,1845420,1846818,1851309,1851850,1341262,-200,541,0.5,"/Volumes/Drive/Thesis/new_data/sub9/log_files/sub9_S2_ASTrain.xls"
"212","92","85",-0.5,65,24,43,2,1625,1862919,1864416,1865813,1870803,1872428,1341262,300,1625,0.5,"/Volumes/Drive/Thesis/new_data/sub9/log_files/sub9_S2_ASTrain.xls"
"213","93","57",0.5,54,19,71,2,528,1882613,1884110,1885508,1889899,1890427,1341262,-300,528,0.5,"/Volumes/Drive/Thesis/new_data/sub9/log_files/sub9_S2_ASTrain.xls"
"214","94","86",-0.5,75,13,64,1,594,1901709,1903206,1904603,1908895,1909489,1341262,-400,594,0.5,"/Volumes/Drive/Thesis/new_data/sub9/log_files/sub9_S2_ASTrain.xls"
"215","95","102",-0.5,84,35,47,1,920,1920305,1921802,1923199,1927990,1928910,1341262,100,920,-0.5,"/Volumes/Drive/Thesis/new_data/sub9/log_files/sub9_S2_ASTrain.xls"
"216","96","46",0.5,29,14,41,1,732,1940116,1941613,1943010,1947302,1948034,1341262,-400,732,-0.5,"/Volumes/Drive/Thesis/new_data/sub9/log_files/sub9_S2_ASTrain.xls"
"217","97","75",-0.5,84,52,42,2,841,1995207,1996704,1998101,2003191,2004032,1995119,400,841,-0.5,"/Volumes/Drive/Thesis/new_data/sub9/log_files/sub9_S2_ASTrain.xls"
"218","98","68",-0.5,46,14,34,1,554,2014701,2016198,2017596,2022087,2022641,1995119,-200,554,-0.5,"/Volumes/Drive/Thesis/new_data/sub9/log_files/sub9_S2_ASTrain.xls"
"219","99","5",0.5,43,14,67,2,937,2034113,2035660,2037057,2042047,2042984,1995119,300,937,-0.5,"/Volumes/Drive/Thesis/new_data/sub9/log_files/sub9_S2_ASTrain.xls"
"220","100","47",0.5,49,23,62,2,680,2053574,2055071,2056468,2060960,2061640,1995119,-200,680,-0.5,"/Volumes/Drive/Thesis/new_data/sub9/log_files/sub9_S2_ASTrain.xls"
"221","101","64",0.5,38,14,62,1,927,2072387,2073884,2075281,2080072,2080999,1995119,100,927,0.5,"/Volumes/Drive/Thesis/new_data/sub9/log_files/sub9_S2_ASTrain.xls"
"222","102","25",0.5,61,18,69,2,540,2091582,2093079,2094476,2099067,2099607,1995119,-100,540,0.5,"/Volumes/Drive/Thesis/new_data/sub9/log_files/sub9_S2_ASTrain.xls"
"223","103","66",-0.5,86,41,43,1,724,2110694,2112191,2113589,2118695,2119419,1995119,400,724,-0.5,"/Volumes/Drive/Thesis/new_data/sub9/log_files/sub9_S2_ASTrain.xls"
"224","104","2",0.5,41,23,74,1,643,2130505,2132002,2133399,2137791,2138434,1995119,-300,643,-0.5,"/Volumes/Drive/Thesis/new_data/sub9/log_files/sub9_S2_ASTrain.xls"
"225","105","126",-0.5,87,38,47,1,753,2149101,2150598,2151996,2157102,2157855,1995119,400,753,0.5,"/Volumes/Drive/Thesis/new_data/sub9/log_files/sub9_S2_ASTrain.xls"
"226","106","99",-0.5,83,25,48,1,894,2168729,2170226,2171623,2176414,2177308,1995119,100,894,-0.5,"/Volumes/Drive/Thesis/new_data/sub9/log_files/sub9_S2_ASTrain.xls"
"227","107","39",0.5,48,27,73,2,1192,2188423,2189920,2191318,2195709,2196901,1995119,-300,1192,-0.5,"/Volumes/Drive/Thesis/new_data/sub9/log_files/sub9_S2_ASTrain.xls"
"228","108","74",-0.5,63,12,41,1,460,2207818,2209315,2210713,2215503,2215963,1995119,100,460,-0.5,"/Volumes/Drive/Thesis/new_data/sub9/log_files/sub9_S2_ASTrain.xls"
"229","109","94",-0.5,86,35,61,1,949,2227513,2229009,2230407,2235513,2236462,1995119,400,949,0.5,"/Volumes/Drive/Thesis/new_data/sub9/log_files/sub9_S2_ASTrain.xls"
"230","110","56",0.5,58,17,65,1,792,2246841,2248338,2249735,2254326,2255118,1995119,-100,792,0.5,"/Volumes/Drive/Thesis/new_data/sub9/log_files/sub9_S2_ASTrain.xls"
"231","111","83",-0.5,48,23,23,2,774,2265737,2267284,2268681,2273671,2274445,1995119,300,774,0.5,"/Volumes/Drive/Thesis/new_data/sub9/log_files/sub9_S2_ASTrain.xls"
"232","112","4",0.5,53,21,76,1,514,2285780,2287277,2288675,2293681,2294195,1995119,300,514,-0.5,"/Volumes/Drive/Thesis/new_data/sub9/log_files/sub9_S2_ASTrain.xls"
"233","113","59",0.5,43,28,81,2,781,2305591,2307088,2308485,2313475,2314256,1995119,300,781,0.5,"/Volumes/Drive/Thesis/new_data/sub9/log_files/sub9_S2_ASTrain.xls"
"234","114","103",-0.5,73,15,68,2,806,2325502,2326999,2328396,2332887,2333693,1995119,-200,806,-0.5,"/Volumes/Drive/Thesis/new_data/sub9/log_files/sub9_S2_ASTrain.xls"
"235","115","128",-0.5,75,27,38,1,606,2344198,2345695,2347092,2351384,2351990,1995119,-400,606,0.5,"/Volumes/Drive/Thesis/new_data/sub9/log_files/sub9_S2_ASTrain.xls"
"236","116","107",-0.5,81,13,78,2,753,2363310,2364807,2366204,2370595,2371348,1995119,-300,753,-0.5,"/Volumes/Drive/Thesis/new_data/sub9/log_files/sub9_S2_ASTrain.xls"
"237","117","37",0.5,46,28,64,2,1462,2382123,2383620,2385017,2389308,2390770,1995119,-400,1462,-0.5,"/Volumes/Drive/Thesis/new_data/sub9/log_files/sub9_S2_ASTrain.xls"
"238","118","127",-0.5,65,27,48,2,569,2401118,2402615,2404012,2408903,2409472,1995119,200,569,0.5,"/Volumes/Drive/Thesis/new_data/sub9/log_files/sub9_S2_ASTrain.xls"
"239","119","112",-0.5,57,18,49,1,810,2420330,2421827,2423224,2428115,2428925,1995119,200,810,-0.5,"/Volumes/Drive/Thesis/new_data/sub9/log_files/sub9_S2_ASTrain.xls"
"240","121","20",0.5,51,24,65,1,1464,2458820,2460317,2461715,2466006,2467470,1995119,-400,1464,0.5,"/Volumes/Drive/Thesis/new_data/sub9/log_files/sub9_S2_ASTrain.xls"
"241","122","29",0.5,45,14,57,2,845,2477933,2479430,2480827,2485218,2486063,1995119,-300,845,0.5,"/Volumes/Drive/Thesis/new_data/sub9/log_files/sub9_S2_ASTrain.xls"
"242","123","90",-0.5,74,43,41,2,961,2496529,2498026,2499423,2503914,2504875,1995119,-200,961,0.5,"/Volumes/Drive/Thesis/new_data/sub9/log_files/sub9_S2_ASTrain.xls"
"243","124","38",0.5,39,25,74,1,854,2516024,2517521,2518918,2523708,2524562,1995119,100,854,-0.5,"/Volumes/Drive/Thesis/new_data/sub9/log_files/sub9_S2_ASTrain.xls"
"244","125","82",-0.5,48,14,32,1,769,2535635,2537132,2538529,2543120,2543889,1995119,-100,769,0.5,"/Volumes/Drive/Thesis/new_data/sub9/log_files/sub9_S2_ASTrain.xls"
"245","127","32",0.5,47,21,78,1,689,2574341,2575838,2577236,2581527,2582216,1995119,-400,689,0.5,"/Volumes/Drive/Thesis/new_data/sub9/log_files/sub9_S2_ASTrain.xls"
"246","128","115",-0.5,64,25,29,1,636,2593154,2594651,2596048,2600939,2601575,1995119,200,636,0.5,"/Volumes/Drive/Thesis/new_data/sub9/log_files/sub9_S2_ASTrain.xls"
"247","2","25",0.5,61,18,69,2,689,49283,50780,52178,56768,57457,30537,-100,689,0.5,"/Volumes/Drive/Thesis/new_data/sub10/log_files/sub10_S2_ASTrain.xls"
"248","3","93",-0.5,68,37,21,2,611,68329,69826,71223,76330,76941,30537,400,611,0.5,"/Volumes/Drive/Thesis/new_data/sub10/log_files/sub10_S2_ASTrain.xls"
"249","4","123",-0.5,62,13,59,2,487,88239,89737,91134,95625,96112,30537,-200,487,0.5,"/Volumes/Drive/Thesis/new_data/sub10/log_files/sub10_S2_ASTrain.xls"
"250","5","18",0.5,32,13,47,1,594,107451,108948,110346,115236,115830,30537,200,594,0.5,"/Volumes/Drive/Thesis/new_data/sub10/log_files/sub10_S2_ASTrain.xls"
"251","6","49",0.5,39,17,58,2,465,126547,128044,129441,133833,134298,30537,-300,465,0.5,"/Volumes/Drive/Thesis/new_data/sub10/log_files/sub10_S2_ASTrain.xls"
"252","7","60",0.5,34,29,53,1,713,145759,147256,148653,153460,154173,30537,100,713,0.5,"/Volumes/Drive/Thesis/new_data/sub10/log_files/sub10_S2_ASTrain.xls"
"253","8","101",-0.5,64,18,48,2,1136,164871,166368,167765,172755,173891,30537,300,1136,-0.5,"/Volumes/Drive/Thesis/new_data/sub10/log_files/sub10_S2_ASTrain.xls"
"254","9","36",0.5,57,18,65,1,573,184582,186079,187476,192067,192640,30537,-100,573,-0.5,"/Volumes/Drive/Thesis/new_data/sub10/log_files/sub10_S2_ASTrain.xls"
"255","10","50",0.5,49,25,72,1,621,204093,205590,206988,211878,212499,30537,200,621,0.5,"/Volumes/Drive/Thesis/new_data/sub10/log_files/sub10_S2_ASTrain.xls"
"256","11","10",0.5,42,37,69,1,527,223505,225002,226399,231190,231717,30537,100,527,-0.5,"/Volumes/Drive/Thesis/new_data/sub10/log_files/sub10_S2_ASTrain.xls"
"257","12","70",-0.5,68,23,35,1,481,242800,244297,245694,249986,250467,30537,-400,481,-0.5,"/Volumes/Drive/Thesis/new_data/sub10/log_files/sub10_S2_ASTrain.xls"
"258","13","13",0.5,58,21,69,2,481,261596,263093,264491,268782,269263,30537,-400,481,-0.5,"/Volumes/Drive/Thesis/new_data/sub10/log_files/sub10_S2_ASTrain.xls"
"259","14","88",-0.5,45,14,41,1,403,280609,282106,283503,288609,289012,30537,400,403,0.5,"/Volumes/Drive/Thesis/new_data/sub10/log_files/sub10_S2_ASTrain.xls"
"260","15","109",-0.5,75,26,47,2,581,300702,302199,303596,308587,309168,30537,300,581,-0.5,"/Volumes/Drive/Thesis/new_data/sub10/log_files/sub10_S2_ASTrain.xls"
"261","16","42",0.5,52,19,61,1,452,320613,322110,323507,328497,328949,30537,300,452,-0.5,"/Volumes/Drive/Thesis/new_data/sub10/log_files/sub10_S2_ASTrain.xls"
"262","17","17",0.5,62,14,78,2,415,340424,341921,343318,348424,348839,30537,400,415,0.5,"/Volumes/Drive/Thesis/new_data/sub10/log_files/sub10_S2_ASTrain.xls"
"263","18","114",-0.5,82,28,52,1,1524,360251,361748,363145,368252,369776,30537,400,1524,0.5,"/Volumes/Drive/Thesis/new_data/sub10/log_files/sub10_S2_ASTrain.xls"
"264","19","67",-0.5,47,13,24,2,565,379762,381259,382657,387148,387713,30537,-200,565,-0.5,"/Volumes/Drive/Thesis/new_data/sub10/log_files/sub10_S2_ASTrain.xls"
"265","20","127",-0.5,65,27,48,2,1281,399274,400771,402168,406759,408040,30537,-100,1281,0.5,"/Volumes/Drive/Thesis/new_data/sub10/log_files/sub10_S2_ASTrain.xls"
"266","21","7",0.5,42,34,78,2,485,418885,420382,421779,426570,427055,30537,100,485,-0.5,"/Volumes/Drive/Thesis/new_data/sub10/log_files/sub10_S2_ASTrain.xls"
"267","22","68",-0.5,46,14,34,1,585,437997,439494,440891,445782,446367,30537,200,585,-0.5,"/Volumes/Drive/Thesis/new_data/sub10/log_files/sub10_S2_ASTrain.xls"
"268","23","106",-0.5,52,13,37,1,581,457808,459305,460702,465692,466273,30537,300,581,-0.5,"/Volumes/Drive/Thesis/new_data/sub10/log_files/sub10_S2_ASTrain.xls"
"269","24","14",0.5,48,21,71,1,485,477802,479299,480696,485287,485772,30537,-100,485,-0.5,"/Volumes/Drive/Thesis/new_data/sub10/log_files/sub10_S2_ASTrain.xls"
"270","25","128",-0.5,75,27,38,1,443,496814,498311,499708,504000,504443,30537,-400,443,0.5,"/Volumes/Drive/Thesis/new_data/sub10/log_files/sub10_S2_ASTrain.xls"
"271","26","75",-0.5,84,52,42,2,476,515510,517007,518405,523295,523771,30537,200,476,-0.5,"/Volumes/Drive/Thesis/new_data/sub10/log_files/sub10_S2_ASTrain.xls"
"272","27","47",0.5,49,23,62,2,525,535404,536901,538299,543089,543614,30537,100,525,-0.5,"/Volumes/Drive/Thesis/new_data/sub10/log_files/sub10_S2_ASTrain.xls"
"273","28","85",-0.5,65,24,43,2,542,554999,556496,557893,562384,562926,30537,-200,542,0.5,"/Volumes/Drive/Thesis/new_data/sub10/log_files/sub10_S2_ASTrain.xls"
"274","29","28",0.5,52,16,78,1,445,573795,575292,576689,580981,581426,30537,-400,445,0.5,"/Volumes/Drive/Thesis/new_data/sub10/log_files/sub10_S2_ASTrain.xls"
"275","30","102",-0.5,84,35,47,2,373,592292,593789,595186,599677,600050,30537,-200,373,-0.5,"/Volumes/Drive/Thesis/new_data/sub10/log_files/sub10_S2_ASTrain.xls"
"276","31","58",0.5,54,18,74,1,384,611005,612502,613899,618290,618674,30537,-300,384,0.5,"/Volumes/Drive/Thesis/new_data/sub10/log_files/sub10_S2_ASTrain.xls"
"277","32","48",0.5,49,24,71,1,471,629917,631414,632811,637203,637674,30537,-300,471,-0.5,"/Volumes/Drive/Thesis/new_data/sub10/log_files/sub10_S2_ASTrain.xls"
"278","33","122",-0.5,52,14,36,1,426,685823,687320,688717,693824,694250,685664,400,426,0.5,"/Volumes/Drive/Thesis/new_data/sub10/log_files/sub10_S2_ASTrain.xls"
"279","34","86",-0.5,75,13,64,1,427,705135,706632,708029,712620,713047,685664,-100,427,0.5,"/Volumes/Drive/Thesis/new_data/sub10/log_files/sub10_S2_ASTrain.xls"
"280","35","43",0.5,43,19,64,2,502,724031,725528,726925,731716,732218,685664,100,502,-0.5,"/Volumes/Drive/Thesis/new_data/sub10/log_files/sub10_S2_ASTrain.xls"
"281","36","107",-0.5,81,13,78,2,439,743243,744740,746137,750528,750967,685664,-300,439,-0.5,"/Volumes/Drive/Thesis/new_data/sub10/log_files/sub10_S2_ASTrain.xls"
"282","37","79",-0.5,49,17,34,2,420,762355,763852,765249,769641,770061,685664,-300,420,-0.5,"/Volumes/Drive/Thesis/new_data/sub10/log_files/sub10_S2_ASTrain.xls"
"283","38","33",0.5,58,16,72,2,549,781467,782964,784361,789152,789701,685664,100,549,-0.5,"/Volumes/Drive/Thesis/new_data/sub10/log_files/sub10_S2_ASTrain.xls"
"284","39","19",0.5,34,23,67,2,409,801178,802675,804072,808963,809372,685664,200,409,0.5,"/Volumes/Drive/Thesis/new_data/sub10/log_files/sub10_S2_ASTrain.xls"
"285","40","97",-0.5,51,19,34,2,413,820473,821970,823368,827958,828371,685664,-100,413,-0.5,"/Volumes/Drive/Thesis/new_data/sub10/log_files/sub10_S2_ASTrain.xls"
"286","41","95",-0.5,68,15,51,2,474,840068,841565,842962,848069,848543,685664,400,474,0.5,"/Volumes/Drive/Thesis/new_data/sub10/log_files/sub10_S2_ASTrain.xls"
"287","42","11",0.5,61,17,76,2,440,859479,860976,862374,866665,867105,685664,-400,440,-0.5,"/Volumes/Drive/Thesis/new_data/sub10/log_files/sub10_S2_ASTrain.xls"
"288","43","83",-0.5,48,23,23,2,423,878492,879989,881386,886493,886916,685664,400,423,0.5,"/Volumes/Drive/Thesis/new_data/sub10/log_files/sub10_S2_ASTrain.xls"
"289","44","113",-0.5,82,19,65,2,1331,898519,900016,901413,905804,907135,685664,-300,1331,0.5,"/Volumes/Drive/Thesis/new_data/sub10/log_files/sub10_S2_ASTrain.xls"
"290","45","20",0.5,51,24,65,1,532,917631,919128,920525,925415,925947,685664,200,532,0.5,"/Volumes/Drive/Thesis/new_data/sub10/log_files/sub10_S2_ASTrain.xls"
"291","46","124",-0.5,72,24,38,1,531,937342,938839,940236,944727,945258,685664,-200,531,0.5,"/Volumes/Drive/Thesis/new_data/sub10/log_files/sub10_S2_ASTrain.xls"
"292","47","71",-0.5,67,14,51,2,563,956155,957652,959049,964039,964602,685664,300,563,-0.5,"/Volumes/Drive/Thesis/new_data/sub10/log_files/sub10_S2_ASTrain.xls"
"293","48","9",0.5,24,15,37,2,471,975350,976847,978244,982536,983007,685664,-400,471,-0.5,"/Volumes/Drive/Thesis/new_data/sub10/log_files/sub10_S2_ASTrain.xls"
"294","49","55",0.5,36,28,74,2,522,994163,995660,997057,1002047,1002569,685664,300,522,0.5,"/Volumes/Drive/Thesis/new_data/sub10/log_files/sub10_S2_ASTrain.xls"
"295","50","27",0.5,41,17,56,2,482,1013475,1014972,1016369,1021259,1021741,685664,200,482,0.5,"/Volumes/Drive/Thesis/new_data/sub10/log_files/sub10_S2_ASTrain.xls"
"296","51","77",-0.5,86,25,71,2,809,1032886,1034383,1035780,1040072,1040881,685664,-400,809,-0.5,"/Volumes/Drive/Thesis/new_data/sub10/log_files/sub10_S2_ASTrain.xls"
"297","53","32",0.5,47,21,78,1,590,1071692,1073190,1074587,1079477,1080067,685664,200,590,0.5,"/Volumes/Drive/Thesis/new_data/sub10/log_files/sub10_S2_ASTrain.xls"
"298","54","99",-0.5,83,25,48,2,1071,1091088,1092585,1093982,1098573,1099644,685664,-100,1071,-0.5,"/Volumes/Drive/Thesis/new_data/sub10/log_files/sub10_S2_ASTrain.xls"
"299","55","72",-0.5,79,21,68,1,609,1110100,1111597,1112994,1117785,1118394,685664,100,609,-0.5,"/Volumes/Drive/Thesis/new_data/sub10/log_files/sub10_S2_ASTrain.xls"
"300","56","57",0.5,54,19,71,2,478,1129395,1130892,1132289,1136681,1137159,685664,-300,478,0.5,"/Volumes/Drive/Thesis/new_data/sub10/log_files/sub10_S2_ASTrain.xls"
"301","57","108",-0.5,72,23,39,1,464,1148590,1150087,1151485,1155976,1156440,685664,-200,464,-0.5,"/Volumes/Drive/Thesis/new_data/sub10/log_files/sub10_S2_ASTrain.xls"
"302","58","8",0.5,24,13,47,1,706,1167287,1168784,1170181,1175171,1175877,685664,300,706,-0.5,"/Volumes/Drive/Thesis/new_data/sub10/log_files/sub10_S2_ASTrain.xls"
"303","59","89",-0.5,54,12,32,2,727,1187197,1188694,1190092,1194383,1195110,685664,-400,727,0.5,"/Volumes/Drive/Thesis/new_data/sub10/log_files/sub10_S2_ASTrain.xls"
"304","61","38",0.5,39,25,74,1,468,1225788,1227285,1228682,1233672,1234140,685664,300,468,-0.5,"/Volumes/Drive/Thesis/new_data/sub10/log_files/sub10_S2_ASTrain.xls"
"305","62","34",0.5,37,28,67,1,446,1245798,1247295,1248692,1253183,1253629,685664,-200,446,-0.5,"/Volumes/Drive/Thesis/new_data/sub10/log_files/sub10_S2_ASTrain.xls"
"306","63","63",0.5,47,24,61,2,593,1265093,1266590,1267987,1272578,1273171,685664,-100,593,0.5,"/Volumes/Drive/Thesis/new_data/sub10/log_files/sub10_S2_ASTrain.xls"
"307","64","16",0.5,45,34,89,1,549,1283889,1285386,1286784,1291574,1292123,685664,100,549,-0.5,"/Volumes/Drive/Thesis/new_data/sub10/log_files/sub10_S2_ASTrain.xls"
"308","65","81",-0.5,76,24,54,2,428,1357993,1359490,1360887,1365677,1366105,1357939,100,428,0.5,"/Volumes/Drive/Thesis/new_data/sub10/log_files/sub10_S2_ASTrain.xls"
"309","66","73",-0.5,83,51,34,2,466,1377487,1378984,1380382,1384873,1385339,1357939,-200,466,-0.5,"/Volumes/Drive/Thesis/new_data/sub10/log_files/sub10_S2_ASTrain.xls"
"310","67","64",0.5,38,14,62,1,547,1396400,1397897,1399294,1403885,1404432,1357939,-100,547,0.5,"/Volumes/Drive/Thesis/new_data/sub10/log_files/sub10_S2_ASTrain.xls"
"311","68","44",0.5,43,29,74,1,482,1415495,1416992,1418390,1422981,1423463,1357939,-100,482,-0.5,"/Volumes/Drive/Thesis/new_data/sub10/log_files/sub10_S2_ASTrain.xls"
"312","69","104",-0.5,51,16,25,1,562,1434907,1436404,1437801,1442791,1443353,1357939,300,562,-0.5,"/Volumes/Drive/Thesis/new_data/sub10/log_files/sub10_S2_ASTrain.xls"
"313","70","12",0.5,62,16,68,1,527,1454102,1455599,1456997,1461388,1461915,1357939,-300,527,-0.5,"/Volumes/Drive/Thesis/new_data/sub10/log_files/sub10_S2_ASTrain.xls"
"314","71","65",-0.5,68,12,54,2,765,1473198,1474695,1476092,1480384,1481149,1357939,-400,765,-0.5,"/Volumes/Drive/Thesis/new_data/sub10/log_files/sub10_S2_ASTrain.xls"
"315","72","26",0.5,31,28,69,1,484,1492210,1493707,1495105,1499695,1500179,1357939,-100,484,0.5,"/Volumes/Drive/Thesis/new_data/sub10/log_files/sub10_S2_ASTrain.xls"
"316","73","62",0.5,59,13,74,1,496,1511123,1512620,1514017,1518808,1519304,1357939,100,496,0.5,"/Volumes/Drive/Thesis/new_data/sub10/log_files/sub10_S2_ASTrain.xls"
"317","74","59",0.5,43,28,81,2,594,1530318,1531815,1533212,1538319,1538913,1357939,400,594,0.5,"/Volumes/Drive/Thesis/new_data/sub10/log_files/sub10_S2_ASTrain.xls"
"318","75","37",0.5,46,28,64,2,489,1550329,1551826,1553223,1558329,1558818,1357939,400,489,-0.5,"/Volumes/Drive/Thesis/new_data/sub10/log_files/sub10_S2_ASTrain.xls"
"319","76","39",0.5,48,27,73,2,520,1569956,1571453,1572851,1577641,1578161,1357939,100,520,-0.5,"/Volumes/Drive/Thesis/new_data/sub10/log_files/sub10_S2_ASTrain.xls"
"320","77","5",0.5,43,14,67,2,467,1589767,1591264,1592661,1597053,1597520,1357939,-300,467,-0.5,"/Volumes/Drive/Thesis/new_data/sub10/log_files/sub10_S2_ASTrain.xls"
"321","78","120",-0.5,71,35,46,1,532,1609079,1610576,1611973,1616863,1617395,1357939,200,532,0.5,"/Volumes/Drive/Thesis/new_data/sub10/log_files/sub10_S2_ASTrain.xls"
"322","79","103",-0.5,73,15,68,2,525,1628490,1629988,1631385,1636275,1636800,1357939,200,525,-0.5,"/Volumes/Drive/Thesis/new_data/sub10/log_files/sub10_S2_ASTrain.xls"
"323","80","29",0.5,45,14,57,2,494,1647586,1649083,1650480,1655587,1656081,1357939,400,494,0.5,"/Volumes/Drive/Thesis/new_data/sub10/log_files/sub10_S2_ASTrain.xls"
"324","81","66",-0.5,86,41,43,1,766,1667696,1669193,1670590,1675580,1676346,1357939,300,766,-0.5,"/Volumes/Drive/Thesis/new_data/sub10/log_files/sub10_S2_ASTrain.xls"
"325","82","2",0.5,41,23,74,1,563,1687707,1689204,1690601,1694892,1695455,1357939,-400,563,-0.5,"/Volumes/Drive/Thesis/new_data/sub10/log_files/sub10_S2_ASTrain.xls"
"326","83","96",-0.5,56,15,31,1,560,1706702,1708199,1709597,1713988,1714548,1357939,-300,560,0.5,"/Volumes/Drive/Thesis/new_data/sub10/log_files/sub10_S2_ASTrain.xls"
"327","84","30",0.5,46,32,68,1,636,1725399,1726896,1728293,1733083,1733719,1357939,100,636,0.5,"/Volumes/Drive/Thesis/new_data/sub10/log_files/sub10_S2_ASTrain.xls"
"328","85","61",0.5,39,24,61,2,434,1745010,1746507,1747904,1752894,1753328,1357939,300,434,0.5,"/Volumes/Drive/Thesis/new_data/sub10/log_files/sub10_S2_ASTrain.xls"
"329","86","118",-0.5,73,27,48,1,552,1764521,1766018,1767415,1771807,1772359,1357939,-300,552,0.5,"/Volumes/Drive/Thesis/new_data/sub10/log_files/sub10_S2_ASTrain.xls"
"330","87","1",0.5,51,23,64,2,635,1783134,1784631,1786029,1790520,1791155,1357939,-200,635,-0.5,"/Volumes/Drive/Thesis/new_data/sub10/log_files/sub10_S2_ASTrain.xls"
"331","88","84",-0.5,89,41,46,1,494,1802047,1803544,1804941,1809832,1810326,1357939,200,494,0.5,"/Volumes/Drive/Thesis/new_data/sub10/log_files/sub10_S2_ASTrain.xls"
"332","89","74",-0.5,63,12,41,1,458,1821242,1822739,1824137,1828727,1829185,1357939,-100,458,-0.5,"/Volumes/Drive/Thesis/new_data/sub10/log_files/sub10_S2_ASTrain.xls"
"333","90","105",-0.5,71,24,49,2,492,1840038,1841535,1842933,1847224,1847716,1357939,-400,492,-0.5,"/Volumes/Drive/Thesis/new_data/sub10/log_files/sub10_S2_ASTrain.xls"
"334","91","31",0.5,67,12,69,2,749,1859134,1860631,1862028,1866919,1867668,1357939,200,749,0.5,"/Volumes/Drive/Thesis/new_data/sub10/log_files/sub10_S2_ASTrain.xls"
"335","93","82",-0.5,48,14,32,1,473,1899055,1900552,1901949,1906241,1906714,1357939,-400,473,0.5,"/Volumes/Drive/Thesis/new_data/sub10/log_files/sub10_S2_ASTrain.xls"
"336","94","117",-0.5,72,29,41,2,725,1918167,1919664,1921061,1926051,1926776,1357939,300,725,0.5,"/Volumes/Drive/Thesis/new_data/sub10/log_files/sub10_S2_ASTrain.xls"
"337","95","45",0.5,48,24,82,2,954,1938061,1939558,1940955,1945446,1946400,1357939,-200,954,-0.5,"/Volumes/Drive/Thesis/new_data/sub10/log_files/sub10_S2_ASTrain.xls"
"338","97","91",-0.5,74,42,42,2,451,2013562,2015059,2016456,2020947,2021398,2013465,-200,451,0.5,"/Volumes/Drive/Thesis/new_data/sub10/log_files/sub10_S2_ASTrain.xls"
"339","98","6",0.5,52,13,67,1,560,2032374,2033871,2035269,2039760,2040320,2013465,-200,560,-0.5,"/Volumes/Drive/Thesis/new_data/sub10/log_files/sub10_S2_ASTrain.xls"
"340","99","69",-0.5,78,31,45,2,634,2051603,2053100,2054497,2059388,2060022,2013465,200,634,-0.5,"/Volumes/Drive/Thesis/new_data/sub10/log_files/sub10_S2_ASTrain.xls"
"341","100","35",0.5,36,17,63,1,466,2071514,2073011,2074408,2079415,2079881,2013465,300,466,-0.5,"/Volumes/Drive/Thesis/new_data/sub10/log_files/sub10_S2_ASTrain.xls"
"342","101","78",-0.5,79,36,53,1,581,2090842,2092339,2093736,2098627,2099208,2013465,200,581,-0.5,"/Volumes/Drive/Thesis/new_data/sub10/log_files/sub10_S2_ASTrain.xls"
"343","102","115",-0.5,64,25,29,2,583,2110753,2112250,2113647,2118437,2119020,2013465,100,583,0.5,"/Volumes/Drive/Thesis/new_data/sub10/log_files/sub10_S2_ASTrain.xls"
"344","103","41",0.5,54,17,81,2,499,2130563,2132060,2133457,2137849,2138348,2013465,-300,499,-0.5,"/Volumes/Drive/Thesis/new_data/sub10/log_files/sub10_S2_ASTrain.xls"
"345","104","121",-0.5,61,24,39,2,451,2149675,2151173,2152570,2157693,2158144,2013465,400,451,0.5,"/Volumes/Drive/Thesis/new_data/sub10/log_files/sub10_S2_ASTrain.xls"
"346","105","4",0.5,53,21,76,1,998,2169021,2170518,2171915,2177021,2178019,2013465,400,998,-0.5,"/Volumes/Drive/Thesis/new_data/sub10/log_files/sub10_S2_ASTrain.xls"
"347","106","92",-0.5,83,21,64,1,463,2188648,2190145,2191543,2196649,2197112,2013465,400,463,0.5,"/Volumes/Drive/Thesis/new_data/sub10/log_files/sub10_S2_ASTrain.xls"
"348","107","80",-0.5,59,18,31,1,533,2208659,2210156,2211553,2216344,2216877,2013465,100,533,-0.5,"/Volumes/Drive/Thesis/new_data/sub10/log_files/sub10_S2_ASTrain.xls"
"349","108","94",-0.5,86,35,61,1,512,2228270,2229767,2231164,2235755,2236267,2013465,-100,512,0.5,"/Volumes/Drive/Thesis/new_data/sub10/log_files/sub10_S2_ASTrain.xls"
"350","109","51",0.5,37,25,72,2,862,2247066,2248563,2249960,2254451,2255313,2013465,-200,862,0.5,"/Volumes/Drive/Thesis/new_data/sub10/log_files/sub10_S2_ASTrain.xls"
"351","110","76",-0.5,53,21,34,1,593,2265862,2267359,2268756,2273048,2273641,2013465,-400,593,-0.5,"/Volumes/Drive/Thesis/new_data/sub10/log_files/sub10_S2_ASTrain.xls"
"352","111","3",0.5,52,24,74,2,576,2285157,2286654,2288052,2293158,2293734,2013465,400,576,-0.5,"/Volumes/Drive/Thesis/new_data/sub10/log_files/sub10_S2_ASTrain.xls"
"353","112","111",-0.5,65,29,38,2,632,2304768,2306266,2307663,2312054,2312686,2013465,-300,632,-0.5,"/Volumes/Drive/Thesis/new_data/sub10/log_files/sub10_S2_ASTrain.xls"
"354","113","116",-0.5,53,17,46,1,608,2323980,2325478,2326875,2331765,2332373,2013465,200,608,0.5,"/Volumes/Drive/Thesis/new_data/sub10/log_files/sub10_S2_ASTrain.xls"
"355","114","46",0.5,29,14,41,1,506,2343176,2344673,2346070,2350461,2350967,2013465,-300,506,-0.5,"/Volumes/Drive/Thesis/new_data/sub10/log_files/sub10_S2_ASTrain.xls"
"356","115","98",-0.5,62,28,32,1,1015,2362088,2363585,2365016,2369607,2370622,2013465,-100,1015,-0.5,"/Volumes/Drive/Thesis/new_data/sub10/log_files/sub10_S2_ASTrain.xls"
"357","116","87",-0.5,86,24,52,2,641,2381134,2382631,2384028,2388918,2389559,2013465,200,641,0.5,"/Volumes/Drive/Thesis/new_data/sub10/log_files/sub10_S2_ASTrain.xls"
"358","117","52",0.5,46,27,63,1,566,2400429,2401926,2403323,2407914,2408480,2013465,-100,566,0.5,"/Volumes/Drive/Thesis/new_data/sub10/log_files/sub10_S2_ASTrain.xls"
"359","118","53",0.5,57,16,75,1,1548,2419741,2421238,2422635,2427026,2428574,2013465,-300,1548,0.5,"/Volumes/Drive/Thesis/new_data/sub10/log_files/sub10_S2_ASTrain.xls"
"360","119","110",-0.5,86,18,58,1,538,2438354,2439851,2441248,2446238,2446776,2013465,300,538,-0.5,"/Volumes/Drive/Thesis/new_data/sub10/log_files/sub10_S2_ASTrain.xls"
"361","120","119",-0.5,54,17,27,2,798,2458265,2459762,2461159,2466149,2466947,2013465,300,798,0.5,"/Volumes/Drive/Thesis/new_data/sub10/log_files/sub10_S2_ASTrain.xls"
"362","121","112",-0.5,57,18,49,1,508,2478175,2479672,2481070,2485361,2485869,2013465,-400,508,-0.5,"/Volumes/Drive/Thesis/new_data/sub10/log_files/sub10_S2_ASTrain.xls"
"363","122","22",0.5,31,23,56,1,680,2496672,2498169,2499566,2504157,2504837,2013465,-100,680,0.5,"/Volumes/Drive/Thesis/new_data/sub10/log_files/sub10_S2_ASTrain.xls"
"364","123","23",0.5,64,12,78,2,500,2516167,2517664,2519061,2523352,2523852,2013465,-400,500,0.5,"/Volumes/Drive/Thesis/new_data/sub10/log_files/sub10_S2_ASTrain.xls"
"365","124","15",0.5,47,31,76,2,508,2534880,2536377,2537773,2542265,2542773,2013465,-200,508,-0.5,"/Volumes/Drive/Thesis/new_data/sub10/log_files/sub10_S2_ASTrain.xls"
"366","125","24",0.5,61,23,82,1,543,2554075,2555572,2556969,2561261,2561804,2013465,-400,543,0.5,"/Volumes/Drive/Thesis/new_data/sub10/log_files/sub10_S2_ASTrain.xls"
"367","126","21",0.5,41,34,73,2,707,2572771,2574268,2575666,2580456,2581163,2013465,100,707,0.5,"/Volumes/Drive/Thesis/new_data/sub10/log_files/sub10_S2_ASTrain.xls"
"368","127","54",0.5,47,35,80,1,518,2592366,2593863,2595260,2600300,2600818,2013465,300,518,0.5,"/Volumes/Drive/Thesis/new_data/sub10/log_files/sub10_S2_ASTrain.xls"
"369","128","40",0.5,67,15,84,1,581,2611927,2613424,2614821,2619612,2620193,2013465,100,581,-0.5,"/Volumes/Drive/Thesis/new_data/sub10/log_files/sub10_S2_ASTrain.xls"
"370","1","41",0.5,54,17,81,2,841,23867,25364,26761,31252,32093,23616,-200,841,-0.5,"/Volumes/Drive/Thesis/new_data/sub11/log_files/sub11_S2_ASTrain.xls"
"371","2","10",0.5,42,37,69,1,730,42663,44160,45557,49849,50579,23616,-400,730,-0.5,"/Volumes/Drive/Thesis/new_data/sub11/log_files/sub11_S2_ASTrain.xls"
"372","3","40",0.5,67,15,84,1,1040,61975,63472,64869,69161,70201,23616,-400,1040,-0.5,"/Volumes/Drive/Thesis/new_data/sub11/log_files/sub11_S2_ASTrain.xls"
"373","4","8",0.5,24,13,47,1,513,80971,82468,83865,88156,88669,23616,-400,513,-0.5,"/Volumes/Drive/Thesis/new_data/sub11/log_files/sub11_S2_ASTrain.xls"
"374","5","56",0.5,58,17,65,1,587,99767,101264,102661,107551,108138,23616,200,587,0.5,"/Volumes/Drive/Thesis/new_data/sub11/log_files/sub11_S2_ASTrain.xls"
"375","6","12",0.5,62,16,68,1,486,119178,120675,122073,126464,126950,23616,-300,486,-0.5,"/Volumes/Drive/Thesis/new_data/sub11/log_files/sub11_S2_ASTrain.xls"
"376","7","67",-0.5,47,13,24,2,702,138390,139887,141284,146075,146777,23616,100,702,-0.5,"/Volumes/Drive/Thesis/new_data/sub11/log_files/sub11_S2_ASTrain.xls"
"377","8","24",0.5,63,23,84,1,1139,157602,159099,160496,165653,166792,23616,400,1139,0.5,"/Volumes/Drive/Thesis/new_data/sub11/log_files/sub11_S2_ASTrain.xls"
"378","9","104",-0.5,51,16,25,1,571,177064,178561,179958,184549,185120,23616,-100,571,-0.5,"/Volumes/Drive/Thesis/new_data/sub11/log_files/sub11_S2_ASTrain.xls"
"379","10","61",0.5,39,24,61,2,974,196375,197872,199270,203661,204635,23616,-300,974,0.5,"/Volumes/Drive/Thesis/new_data/sub11/log_files/sub11_S2_ASTrain.xls"
"380","11","22",0.5,31,23,56,1,1178,215471,216968,218365,223472,224650,23616,400,1178,0.5,"/Volumes/Drive/Thesis/new_data/sub11/log_files/sub11_S2_ASTrain.xls"
"381","12","128",-0.5,75,27,38,1,693,235382,236879,238276,243066,243759,23616,100,693,0.5,"/Volumes/Drive/Thesis/new_data/sub11/log_files/sub11_S2_ASTrain.xls"
"382","13","127",-0.5,65,27,48,2,718,254677,256174,257571,261962,262680,23616,-300,718,0.5,"/Volumes/Drive/Thesis/new_data/sub11/log_files/sub11_S2_ASTrain.xls"
"383","14","62",0.5,59,13,74,1,596,273589,275086,276483,281474,282070,23616,300,596,0.5,"/Volumes/Drive/Thesis/new_data/sub11/log_files/sub11_S2_ASTrain.xls"
"384","15","99",-0.5,83,25,48,2,779,292984,294481,295878,300869,301648,23616,300,779,-0.5,"/Volumes/Drive/Thesis/new_data/sub11/log_files/sub11_S2_ASTrain.xls"
"385","16","20",0.5,51,24,65,1,587,312978,314475,315872,320263,320850,23616,-300,587,0.5,"/Volumes/Drive/Thesis/new_data/sub11/log_files/sub11_S2_ASTrain.xls"
"386","17","121",-0.5,61,24,39,2,658,331791,333288,334685,339176,339834,23616,-200,658,0.5,"/Volumes/Drive/Thesis/new_data/sub11/log_files/sub11_S2_ASTrain.xls"
"387","19","85",-0.5,65,24,43,2,807,370281,371778,373175,378166,378973,23616,300,807,0.5,"/Volumes/Drive/Thesis/new_data/sub11/log_files/sub11_S2_ASTrain.xls"
"388","20","70",-0.5,68,23,35,1,627,389476,390974,392371,397361,397988,23616,300,627,-0.5,"/Volumes/Drive/Thesis/new_data/sub11/log_files/sub11_S2_ASTrain.xls"
"389","21","11",0.5,61,17,76,2,746,408772,410269,411666,416273,417019,23616,-100,746,-0.5,"/Volumes/Drive/Thesis/new_data/sub11/log_files/sub11_S2_ASTrain.xls"
"390","22","36",0.5,57,18,65,1,622,428383,429880,431277,436068,436690,23616,100,622,-0.5,"/Volumes/Drive/Thesis/new_data/sub11/log_files/sub11_S2_ASTrain.xls"
"391","23","49",0.5,39,17,58,2,799,447395,448892,450289,454781,455580,23616,-200,799,0.5,"/Volumes/Drive/Thesis/new_data/sub11/log_files/sub11_S2_ASTrain.xls"
"392","24","65",-0.5,68,12,54,2,723,466807,468304,469701,474808,475531,23616,400,723,-0.5,"/Volumes/Drive/Thesis/new_data/sub11/log_files/sub11_S2_ASTrain.xls"
"393","25","80",-0.5,59,18,31,1,512,486634,488131,489528,494020,494532,23616,-200,512,-0.5,"/Volumes/Drive/Thesis/new_data/sub11/log_files/sub11_S2_ASTrain.xls"
"394","26","37",0.5,46,28,64,2,767,506029,507526,508923,514030,514797,23616,400,767,-0.5,"/Volumes/Drive/Thesis/new_data/sub11/log_files/sub11_S2_ASTrain.xls"
"395","27","90",-0.5,74,43,41,1,589,525956,527453,528851,533442,534031,23616,-100,589,0.5,"/Volumes/Drive/Thesis/new_data/sub11/log_files/sub11_S2_ASTrain.xls"
"396","28","98",-0.5,62,28,32,1,593,545468,546965,548362,552953,553546,23616,-100,593,-0.5,"/Volumes/Drive/Thesis/new_data/sub11/log_files/sub11_S2_ASTrain.xls"
"397","29","105",-0.5,71,24,49,2,749,565062,566559,567990,572281,573030,23616,-400,749,-0.5,"/Volumes/Drive/Thesis/new_data/sub11/log_files/sub11_S2_ASTrain.xls"
"398","30","18",0.5,32,13,47,1,558,583609,585106,586503,591393,591951,23616,200,558,0.5,"/Volumes/Drive/Thesis/new_data/sub11/log_files/sub11_S2_ASTrain.xls"
"399","31","125",-0.5,75,38,39,1,1659,602904,604401,605798,610589,612248,23616,100,1659,0.5,"/Volumes/Drive/Thesis/new_data/sub11/log_files/sub11_S2_ASTrain.xls"
"400","32","96",-0.5,56,15,31,1,626,621900,623397,624794,629684,630310,23616,200,626,0.5,"/Volumes/Drive/Thesis/new_data/sub11/log_files/sub11_S2_ASTrain.xls"
"401","33","114",-0.5,82,28,52,1,577,674013,675510,676908,681798,682375,673976,200,577,0.5,"/Volumes/Drive/Thesis/new_data/sub11/log_files/sub11_S2_ASTrain.xls"
"402","34","35",0.5,36,17,63,2,824,693408,694905,696302,701093,701917,673976,100,824,-0.5,"/Volumes/Drive/Thesis/new_data/sub11/log_files/sub11_S2_ASTrain.xls"
"403","35","46",0.5,29,14,41,1,950,712504,714001,715398,720388,721338,673976,300,950,-0.5,"/Volumes/Drive/Thesis/new_data/sub11/log_files/sub11_S2_ASTrain.xls"
"404","36","52",0.5,46,27,63,1,607,732314,733812,735209,740199,740806,673976,300,607,0.5,"/Volumes/Drive/Thesis/new_data/sub11/log_files/sub11_S2_ASTrain.xls"
"405","37","28",0.5,52,16,78,1,565,751709,753206,754604,759710,760275,673976,400,565,0.5,"/Volumes/Drive/Thesis/new_data/sub11/log_files/sub11_S2_ASTrain.xls"
"406","38","60",0.5,34,29,53,2,879,771537,773034,774431,778723,779602,673976,-400,879,0.5,"/Volumes/Drive/Thesis/new_data/sub11/log_files/sub11_S2_ASTrain.xls"
"407","39","17",0.5,62,14,78,2,696,790034,791531,792928,797718,798414,673976,100,696,0.5,"/Volumes/Drive/Thesis/new_data/sub11/log_files/sub11_S2_ASTrain.xls"
"408","40","103",-0.5,73,15,68,2,1036,809728,811225,812622,817612,818648,673976,300,1036,-0.5,"/Volumes/Drive/Thesis/new_data/sub11/log_files/sub11_S2_ASTrain.xls"
"409","41","109",-0.5,75,26,47,2,777,829638,831136,832533,837323,838100,673976,100,777,-0.5,"/Volumes/Drive/Thesis/new_data/sub11/log_files/sub11_S2_ASTrain.xls"
"410","42","110",-0.5,86,18,58,1,659,848634,850131,851529,856519,857178,673976,300,659,-0.5,"/Volumes/Drive/Thesis/new_data/sub11/log_files/sub11_S2_ASTrain.xls"
"411","43","25",0.5,61,18,69,2,760,868329,869826,871223,875714,876474,673976,-200,760,0.5,"/Volumes/Drive/Thesis/new_data/sub11/log_files/sub11_S2_ASTrain.xls"
"412","44","15",0.5,47,31,76,2,758,887025,888522,889919,894809,895567,673976,200,758,-0.5,"/Volumes/Drive/Thesis/new_data/sub11/log_files/sub11_S2_ASTrain.xls"
"413","45","86",-0.5,75,13,64,1,587,906719,908216,909614,914105,914692,673976,-200,587,0.5,"/Volumes/Drive/Thesis/new_data/sub11/log_files/sub11_S2_ASTrain.xls"
"414","46","87",-0.5,86,24,52,2,838,926131,927628,929025,933416,934254,673976,-300,838,0.5,"/Volumes/Drive/Thesis/new_data/sub11/log_files/sub11_S2_ASTrain.xls"
"415","47","53",0.5,58,16,76,2,525,945343,946840,948237,952728,953253,673976,-200,525,0.5,"/Volumes/Drive/Thesis/new_data/sub11/log_files/sub11_S2_ASTrain.xls"
"416","48","93",-0.5,68,37,21,2,616,964538,966035,967432,971824,972440,673976,-300,616,0.5,"/Volumes/Drive/Thesis/new_data/sub11/log_files/sub11_S2_ASTrain.xls"
"417","49","116",-0.5,51,19,42,1,581,983950,985447,986844,991734,992315,673976,200,581,0.5,"/Volumes/Drive/Thesis/new_data/sub11/log_files/sub11_S2_ASTrain.xls"
"418","50","72",-0.5,79,21,68,1,543,1003661,1005158,1006555,1011146,1011689,673976,-100,543,-0.5,"/Volumes/Drive/Thesis/new_data/sub11/log_files/sub11_S2_ASTrain.xls"
"419","51","123",-0.5,62,13,59,2,628,1022557,1024054,1025451,1029842,1030470,673976,-300,628,0.5,"/Volumes/Drive/Thesis/new_data/sub11/log_files/sub11_S2_ASTrain.xls"
"420","52","78",-0.5,79,36,53,1,675,1041353,1042850,1044247,1048638,1049313,673976,-300,675,-0.5,"/Volumes/Drive/Thesis/new_data/sub11/log_files/sub11_S2_ASTrain.xls"
"421","53","79",-0.5,49,17,34,2,598,1060748,1062245,1063642,1067933,1068531,673976,-400,598,-0.5,"/Volumes/Drive/Thesis/new_data/sub11/log_files/sub11_S2_ASTrain.xls"
"422","54","19",0.5,34,23,67,2,860,1079560,1081057,1082455,1087046,1087906,673976,-100,860,0.5,"/Volumes/Drive/Thesis/new_data/sub11/log_files/sub11_S2_ASTrain.xls"
"423","55","38",0.5,39,25,74,1,816,1098357,1099854,1101251,1105542,1106358,673976,-400,816,-0.5,"/Volumes/Drive/Thesis/new_data/sub11/log_files/sub11_S2_ASTrain.xls"
"424","56","122",-0.5,52,14,36,1,831,1116970,1118467,1119864,1124355,1125186,673976,-200,831,0.5,"/Volumes/Drive/Thesis/new_data/sub11/log_files/sub11_S2_ASTrain.xls"
"425","57","3",0.5,52,24,74,2,733,1135982,1137479,1138876,1143983,1144716,673976,400,733,-0.5,"/Volumes/Drive/Thesis/new_data/sub11/log_files/sub11_S2_ASTrain.xls"
"426","58","76",-0.5,53,21,34,1,524,1155410,1156907,1158305,1163411,1163935,673976,400,524,-0.5,"/Volumes/Drive/Thesis/new_data/sub11/log_files/sub11_S2_ASTrain.xls"
"427","59","14",0.5,48,21,71,1,571,1175437,1176934,1178332,1183222,1183793,673976,200,571,-0.5,"/Volumes/Drive/Thesis/new_data/sub11/log_files/sub11_S2_ASTrain.xls"
"428","60","50",0.5,49,25,72,1,684,1194749,1196246,1197643,1202234,1202918,673976,-100,684,0.5,"/Volumes/Drive/Thesis/new_data/sub11/log_files/sub11_S2_ASTrain.xls"
"429","61","13",0.5,58,21,69,2,718,1213761,1215258,1216656,1221762,1222480,673976,400,718,-0.5,"/Volumes/Drive/Thesis/new_data/sub11/log_files/sub11_S2_ASTrain.xls"
"430","62","102",-0.5,84,35,47,1,765,1233589,1235086,1236483,1241074,1241839,673976,-100,765,-0.5,"/Volumes/Drive/Thesis/new_data/sub11/log_files/sub11_S2_ASTrain.xls"
"431","63","95",-0.5,68,15,51,2,609,1253200,1254697,1256094,1260885,1261494,673976,100,609,0.5,"/Volumes/Drive/Thesis/new_data/sub11/log_files/sub11_S2_ASTrain.xls"
"432","64","43",0.5,43,19,64,2,688,1272495,1273992,1275389,1279681,1280369,673976,-400,688,-0.5,"/Volumes/Drive/Thesis/new_data/sub11/log_files/sub11_S2_ASTrain.xls"
"433","65","66",-0.5,86,41,43,1,567,1326206,1327703,1329100,1333691,1334258,1326052,-100,567,-0.5,"/Volumes/Drive/Thesis/new_data/sub11/log_files/sub11_S2_ASTrain.xls"
"434","66","57",0.5,54,19,71,2,751,1345617,1347114,1348511,1352803,1353554,1326052,-400,751,0.5,"/Volumes/Drive/Thesis/new_data/sub11/log_files/sub11_S2_ASTrain.xls"
"435","67","55",0.5,35,28,73,2,847,1364330,1365827,1367224,1372331,1373178,1326052,400,847,0.5,"/Volumes/Drive/Thesis/new_data/sub11/log_files/sub11_S2_ASTrain.xls"
"436","68","83",-0.5,48,23,23,2,706,1383758,1385255,1386653,1391144,1391850,1326052,-200,706,0.5,"/Volumes/Drive/Thesis/new_data/sub11/log_files/sub11_S2_ASTrain.xls"
"437","69","94",-0.5,86,35,61,1,982,1403270,1404767,1406164,1410555,1411537,1326052,-300,982,0.5,"/Volumes/Drive/Thesis/new_data/sub11/log_files/sub11_S2_ASTrain.xls"
"438","70","5",0.5,43,14,67,2,623,1422681,1424178,1425575,1430366,1430989,1326052,100,623,-0.5,"/Volumes/Drive/Thesis/new_data/sub11/log_files/sub11_S2_ASTrain.xls"
"439","71","88",-0.5,45,14,41,1,558,1442492,1443989,1445386,1450493,1451051,1326052,400,558,0.5,"/Volumes/Drive/Thesis/new_data/sub11/log_files/sub11_S2_ASTrain.xls"
"440","72","111",-0.5,65,29,38,2,790,1461904,1463401,1464798,1469089,1469879,1326052,-400,790,-0.5,"/Volumes/Drive/Thesis/new_data/sub11/log_files/sub11_S2_ASTrain.xls"
"441","73","26",0.5,31,28,69,1,852,1480400,1481897,1483295,1487885,1488737,1326052,-100,852,0.5,"/Volumes/Drive/Thesis/new_data/sub11/log_files/sub11_S2_ASTrain.xls"
"442","74","118",-0.5,73,27,48,1,605,1499712,1501209,1502606,1506898,1507503,1326052,-400,605,0.5,"/Volumes/Drive/Thesis/new_data/sub11/log_files/sub11_S2_ASTrain.xls"
"443","75","63",0.5,47,24,61,1,980,1518924,1520421,1521818,1526709,1527689,1326052,200,980,0.5,"/Volumes/Drive/Thesis/new_data/sub11/log_files/sub11_S2_ASTrain.xls"
"444","76","113",-0.5,82,19,65,2,665,1538136,1539633,1541030,1545821,1546486,1326052,100,665,0.5,"/Volumes/Drive/Thesis/new_data/sub11/log_files/sub11_S2_ASTrain.xls"
"445","77","112",-0.5,57,18,49,1,701,1557248,1558745,1560142,1564534,1565235,1326052,-300,701,-0.5,"/Volumes/Drive/Thesis/new_data/sub11/log_files/sub11_S2_ASTrain.xls"
"446","78","51",0.5,37,25,72,2,973,1575861,1577358,1578756,1583746,1584719,1326052,300,973,0.5,"/Volumes/Drive/Thesis/new_data/sub11/log_files/sub11_S2_ASTrain.xls"
"447","79","44",0.5,43,29,74,1,961,1595057,1596554,1597951,1602242,1603203,1326052,-400,961,-0.5,"/Volumes/Drive/Thesis/new_data/sub11/log_files/sub11_S2_ASTrain.xls"
"448","80","107",-0.5,81,13,78,2,690,1613853,1615350,1616747,1621637,1622327,1326052,200,690,-0.5,"/Volumes/Drive/Thesis/new_data/sub11/log_files/sub11_S2_ASTrain.xls"
"449","81","75",-0.5,84,52,42,2,1056,1633464,1634961,1636358,1640849,1641905,1326052,-200,1056,-0.5,"/Volumes/Drive/Thesis/new_data/sub11/log_files/sub11_S2_ASTrain.xls"
"450","82","73",-0.5,83,51,34,2,582,1652975,1654472,1655870,1660760,1661342,1326052,200,582,-0.5,"/Volumes/Drive/Thesis/new_data/sub11/log_files/sub11_S2_ASTrain.xls"
"451","83","42",0.5,52,19,61,1,557,1672587,1674084,1675481,1679972,1680529,1326052,-200,557,-0.5,"/Volumes/Drive/Thesis/new_data/sub11/log_files/sub11_S2_ASTrain.xls"
"452","84","97",-0.5,51,19,34,2,579,1691898,1693395,1694793,1699683,1700262,1326052,200,579,-0.5,"/Volumes/Drive/Thesis/new_data/sub11/log_files/sub11_S2_ASTrain.xls"
"453","85","33",0.5,58,16,72,2,594,1711593,1713090,1714487,1719277,1719871,1326052,100,594,-0.5,"/Volumes/Drive/Thesis/new_data/sub11/log_files/sub11_S2_ASTrain.xls"
"454","86","74",-0.5,63,12,41,1,642,1731187,1732684,1734081,1739072,1739714,1326052,300,642,-0.5,"/Volumes/Drive/Thesis/new_data/sub11/log_files/sub11_S2_ASTrain.xls"
"455","87","31",0.5,67,12,69,2,1085,1751081,1752578,1753975,1759082,1760167,1326052,400,1085,0.5,"/Volumes/Drive/Thesis/new_data/sub11/log_files/sub11_S2_ASTrain.xls"
"456","88","2",0.5,41,23,74,1,982,1770609,1772106,1773503,1778294,1779276,1326052,100,982,-0.5,"/Volumes/Drive/Thesis/new_data/sub11/log_files/sub11_S2_ASTrain.xls"
"457","89","45",0.5,48,24,82,2,632,1789821,1791318,1792715,1797706,1798338,1326052,300,632,-0.5,"/Volumes/Drive/Thesis/new_data/sub11/log_files/sub11_S2_ASTrain.xls"
"458","90","92",-0.5,83,21,64,1,748,1809532,1811029,1812426,1817433,1818181,1326052,300,748,0.5,"/Volumes/Drive/Thesis/new_data/sub11/log_files/sub11_S2_ASTrain.xls"
"459","91","32",0.5,47,21,78,1,722,1828761,1830258,1831655,1836146,1836868,1326052,-200,722,0.5,"/Volumes/Drive/Thesis/new_data/sub11/log_files/sub11_S2_ASTrain.xls"
"460","92","27",0.5,41,17,56,2,668,1847773,1849270,1850667,1855059,1855727,1326052,-300,668,0.5,"/Volumes/Drive/Thesis/new_data/sub11/log_files/sub11_S2_ASTrain.xls"
"461","93","6",0.5,52,13,67,1,1164,1866686,1868183,1869580,1874171,1875335,1326052,-100,1164,-0.5,"/Volumes/Drive/Thesis/new_data/sub11/log_files/sub11_S2_ASTrain.xls"
"462","94","126",-0.5,86,38,46,1,1069,1885698,1887195,1888592,1893699,1894768,1326052,400,1069,0.5,"/Volumes/Drive/Thesis/new_data/sub11/log_files/sub11_S2_ASTrain.xls"
"463","95","120",-0.5,71,35,46,1,573,1905725,1907222,1908619,1913011,1913584,1326052,-300,573,0.5,"/Volumes/Drive/Thesis/new_data/sub11/log_files/sub11_S2_ASTrain.xls"
"464","96","1",0.5,51,23,64,2,679,1924638,1926135,1927532,1932123,1932802,1326052,-100,679,-0.5,"/Volumes/Drive/Thesis/new_data/sub11/log_files/sub11_S2_ASTrain.xls"
"465","97","115",-0.5,64,25,29,2,627,1990391,1991888,1993285,1998392,1999019,1990361,400,627,0.5,"/Volumes/Drive/Thesis/new_data/sub11/log_files/sub11_S2_ASTrain.xls"
"466","98","23",0.5,62,14,78,2,950,2010401,2011898,2013295,2017787,2018737,1990361,-200,950,0.5,"/Volumes/Drive/Thesis/new_data/sub11/log_files/sub11_S2_ASTrain.xls"
"467","99","39",0.5,48,27,73,2,638,2029414,2030911,2032308,2036599,2037237,1990361,-400,638,-0.5,"/Volumes/Drive/Thesis/new_data/sub11/log_files/sub11_S2_ASTrain.xls"
"468","100","34",0.5,37,28,67,1,807,2047927,2049424,2050821,2055711,2056518,1990361,200,807,-0.5,"/Volumes/Drive/Thesis/new_data/sub11/log_files/sub11_S2_ASTrain.xls"
"469","101","108",-0.5,72,23,39,1,687,2067222,2068719,2070116,2074408,2075095,1990361,-400,687,-0.5,"/Volumes/Drive/Thesis/new_data/sub11/log_files/sub11_S2_ASTrain.xls"
"470","102","77",-0.5,86,25,71,2,738,2086434,2087931,2089328,2094435,2095173,1990361,400,738,-0.5,"/Volumes/Drive/Thesis/new_data/sub11/log_files/sub11_S2_ASTrain.xls"
"471","103","100",-0.5,74,35,49,1,656,2106261,2107758,2109156,2113547,2114203,1990361,-300,656,-0.5,"/Volumes/Drive/Thesis/new_data/sub11/log_files/sub11_S2_ASTrain.xls"
"472","104","82",-0.5,48,14,32,1,586,2125174,2126671,2128068,2132460,2133046,1990361,-300,586,0.5,"/Volumes/Drive/Thesis/new_data/sub11/log_files/sub11_S2_ASTrain.xls"
"473","105","54",0.5,47,35,80,1,853,2144386,2145883,2147280,2151771,2152624,1990361,-200,853,0.5,"/Volumes/Drive/Thesis/new_data/sub11/log_files/sub11_S2_ASTrain.xls"
"474","106","47",0.5,49,23,62,1,547,2163099,2164596,2165993,2170983,2171530,1990361,300,547,-0.5,"/Volumes/Drive/Thesis/new_data/sub11/log_files/sub11_S2_ASTrain.xls"
"475","107","91",-0.5,74,42,42,2,599,2183093,2184590,2185987,2190977,2191576,1990361,300,599,0.5,"/Volumes/Drive/Thesis/new_data/sub11/log_files/sub11_S2_ASTrain.xls"
"476","108","4",0.5,53,21,76,1,659,2203103,2204600,2205997,2210588,2211247,1990361,-100,659,-0.5,"/Volumes/Drive/Thesis/new_data/sub11/log_files/sub11_S2_ASTrain.xls"
"477","109","16",0.5,45,34,89,1,688,2222199,2223696,2225093,2229684,2230372,1990361,-100,688,-0.5,"/Volumes/Drive/Thesis/new_data/sub11/log_files/sub11_S2_ASTrain.xls"
"478","110","58",0.5,54,18,74,1,482,2241810,2243307,2244704,2249295,2249777,1990361,-100,482,0.5,"/Volumes/Drive/Thesis/new_data/sub11/log_files/sub11_S2_ASTrain.xls"
"479","111","29",0.5,45,14,57,2,930,2261221,2262718,2264116,2269222,2270152,1990361,400,930,0.5,"/Volumes/Drive/Thesis/new_data/sub11/log_files/sub11_S2_ASTrain.xls"
"480","112","69",-0.5,78,31,45,2,618,2280633,2282130,2283527,2288018,2288636,1990361,-200,618,-0.5,"/Volumes/Drive/Thesis/new_data/sub11/log_files/sub11_S2_ASTrain.xls"
"481","113","124",-0.5,71,24,37,1,810,2299446,2300943,2302340,2306731,2307541,1990361,-300,810,0.5,"/Volumes/Drive/Thesis/new_data/sub11/log_files/sub11_S2_ASTrain.xls"
"482","114","9",0.5,24,15,37,2,699,2318641,2320138,2321535,2326326,2327025,1990361,100,699,-0.5,"/Volumes/Drive/Thesis/new_data/sub11/log_files/sub11_S2_ASTrain.xls"
"483","115","119",-0.5,54,17,27,2,745,2337953,2339450,2340847,2345139,2345884,1990361,-400,745,0.5,"/Volumes/Drive/Thesis/new_data/sub11/log_files/sub11_S2_ASTrain.xls"
"484","116","21",0.5,42,34,74,2,1190,2356549,2358046,2359444,2364334,2365524,1990361,200,1190,0.5,"/Volumes/Drive/Thesis/new_data/sub11/log_files/sub11_S2_ASTrain.xls"
"485","117","106",-0.5,52,13,37,1,594,2375645,2377142,2378539,2383429,2384023,1990361,200,594,-0.5,"/Volumes/Drive/Thesis/new_data/sub11/log_files/sub11_S2_ASTrain.xls"
"486","118","71",-0.5,67,14,51,2,568,2395239,2396736,2398134,2402924,2403492,1990361,100,568,-0.5,"/Volumes/Drive/Thesis/new_data/sub11/log_files/sub11_S2_ASTrain.xls"
"487","119","101",-0.5,64,18,48,2,780,2414850,2416348,2417745,2422336,2423116,1990361,-100,780,-0.5,"/Volumes/Drive/Thesis/new_data/sub11/log_files/sub11_S2_ASTrain.xls"
"488","120","48",0.5,49,24,71,1,662,2434362,2435859,2437256,2442047,2442709,1990361,100,662,-0.5,"/Volumes/Drive/Thesis/new_data/sub11/log_files/sub11_S2_ASTrain.xls"
"489","121","59",0.5,43,28,81,2,1162,2453557,2455054,2456451,2460843,2462005,1990361,-300,1162,0.5,"/Volumes/Drive/Thesis/new_data/sub11/log_files/sub11_S2_ASTrain.xls"
"490","122","117",-0.5,72,29,41,2,887,2472170,2473667,2475065,2480055,2480942,1990361,300,887,0.5,"/Volumes/Drive/Thesis/new_data/sub11/log_files/sub11_S2_ASTrain.xls"
"491","123","81",-0.5,76,24,54,2,769,2491482,2492979,2494376,2499267,2500036,1990361,200,769,0.5,"/Volumes/Drive/Thesis/new_data/sub11/log_files/sub11_S2_ASTrain.xls"
"492","124","30",0.5,45,34,69,1,521,2510794,2512291,2513688,2518795,2519316,1990361,400,521,0.5,"/Volumes/Drive/Thesis/new_data/sub11/log_files/sub11_S2_ASTrain.xls"
"493","125","89",-0.5,54,12,32,2,681,2530621,2532118,2533516,2537807,2538488,1990361,-400,681,0.5,"/Volumes/Drive/Thesis/new_data/sub11/log_files/sub11_S2_ASTrain.xls"
"494","126","68",-0.5,46,14,34,1,720,2549334,2550831,2552229,2556720,2557440,1990361,-200,720,-0.5,"/Volumes/Drive/Thesis/new_data/sub11/log_files/sub11_S2_ASTrain.xls"
"495","127","7",0.5,42,34,78,2,802,2568546,2570043,2571441,2576231,2577033,1990361,100,802,-0.5,"/Volumes/Drive/Thesis/new_data/sub11/log_files/sub11_S2_ASTrain.xls"
"496","128","64",0.5,38,14,62,1,578,2588257,2589754,2591151,2596142,2596720,1990361,300,578,0.5,"/Volumes/Drive/Thesis/new_data/sub11/log_files/sub11_S2_ASTrain.xls"
"497","1","10",0.5,42,37,69,2,804,47220,48717,50114,54705,55509,47013,-100,804,-0.5,"/Volumes/Drive/Thesis/new_data/sub14/log_files/sub14_S2_ASTrain.xls"
"498","2","6",0.5,52,13,67,2,1650,66032,67529,68926,73218,74868,47013,-400,1650,-0.5,"/Volumes/Drive/Thesis/new_data/sub14/log_files/sub14_S2_ASTrain.xls"
"499","3","105",-0.5,71,24,49,2,565,85343,86840,88238,93145,93710,47013,200,565,-0.5,"/Volumes/Drive/Thesis/new_data/sub14/log_files/sub14_S2_ASTrain.xls"
"500","4","41",0.5,54,17,81,2,491,104671,106168,107566,112672,113163,47013,400,491,-0.5,"/Volumes/Drive/Thesis/new_data/sub14/log_files/sub14_S2_ASTrain.xls"
"501","5","72",-0.5,79,21,68,1,508,124582,126079,127474,132482,132990,47013,300,508,-0.5,"/Volumes/Drive/Thesis/new_data/sub14/log_files/sub14_S2_ASTrain.xls"
"502","6","64",0.5,38,14,62,1,500,144492,145989,147386,152176,152676,47013,100,500,0.5,"/Volumes/Drive/Thesis/new_data/sub14/log_files/sub14_S2_ASTrain.xls"
"503","7","82",-0.5,48,14,32,1,528,164003,165500,166897,171288,171816,47013,-300,528,0.5,"/Volumes/Drive/Thesis/new_data/sub14/log_files/sub14_S2_ASTrain.xls"
"504","8","16",0.5,45,34,89,1,523,183397,184894,186292,190683,191206,47013,-300,523,-0.5,"/Volumes/Drive/Thesis/new_data/sub14/log_files/sub14_S2_ASTrain.xls"
"505","9","63",0.5,47,24,61,2,580,202808,204305,205703,210593,211173,47013,200,580,0.5,"/Volumes/Drive/Thesis/new_data/sub14/log_files/sub14_S2_ASTrain.xls"
"506","10","38",0.5,39,25,74,2,422,222502,223999,225397,229688,230110,47013,-400,422,-0.5,"/Volumes/Drive/Thesis/new_data/sub14/log_files/sub14_S2_ASTrain.xls"
"507","11","112",-0.5,57,18,49,1,506,241714,243211,244608,248900,249406,47013,-400,506,-0.5,"/Volumes/Drive/Thesis/new_data/sub14/log_files/sub14_S2_ASTrain.xls"
"508","12","113",-0.5,82,19,65,2,381,260526,262023,263421,268211,268592,47013,100,381,0.5,"/Volumes/Drive/Thesis/new_data/sub14/log_files/sub14_S2_ASTrain.xls"
"509","13","40",0.5,67,15,84,1,503,279838,281335,282732,287323,287826,47013,-100,503,-0.5,"/Volumes/Drive/Thesis/new_data/sub14/log_files/sub14_S2_ASTrain.xls"
"510","14","100",-0.5,74,35,49,1,722,299149,300646,302043,306634,307356,47013,-100,722,-0.5,"/Volumes/Drive/Thesis/new_data/sub14/log_files/sub14_S2_ASTrain.xls"
"511","15","102",-0.5,84,35,47,1,573,318660,320157,321554,326345,326918,47013,100,573,-0.5,"/Volumes/Drive/Thesis/new_data/sub14/log_files/sub14_S2_ASTrain.xls"
"512","16","74",-0.5,63,12,41,1,456,337772,339269,340666,345773,346229,47013,400,456,-0.5,"/Volumes/Drive/Thesis/new_data/sub14/log_files/sub14_S2_ASTrain.xls"
"513","17","29",0.5,45,14,57,2,1149,357100,358597,359994,365001,366150,47013,300,1149,0.5,"/Volumes/Drive/Thesis/new_data/sub14/log_files/sub14_S2_ASTrain.xls"
"514","18","19",0.5,34,23,67,2,625,376827,378324,379721,384212,384837,47013,-200,625,0.5,"/Volumes/Drive/Thesis/new_data/sub14/log_files/sub14_S2_ASTrain.xls"
"515","19","66",-0.5,86,41,43,1,469,396122,397619,399016,403507,403976,47013,-200,469,-0.5,"/Volumes/Drive/Thesis/new_data/sub14/log_files/sub14_S2_ASTrain.xls"
"516","20","81",-0.5,76,24,54,2,482,414868,416365,417762,422868,423350,47013,400,482,0.5,"/Volumes/Drive/Thesis/new_data/sub14/log_files/sub14_S2_ASTrain.xls"
"517","21","123",-0.5,62,13,59,2,471,434196,435693,437090,442097,442568,47013,300,471,0.5,"/Volumes/Drive/Thesis/new_data/sub14/log_files/sub14_S2_ASTrain.xls"
"518","22","11",0.5,61,17,76,2,455,453723,455220,456618,460909,461364,47013,-400,455,-0.5,"/Volumes/Drive/Thesis/new_data/sub14/log_files/sub14_S2_ASTrain.xls"
"519","23","119",-0.5,54,17,27,2,492,472336,473833,475230,480121,480613,47013,200,492,0.5,"/Volumes/Drive/Thesis/new_data/sub14/log_files/sub14_S2_ASTrain.xls"
"520","24","127",-0.5,65,27,48,2,431,492030,493527,494924,499931,500362,47013,300,431,0.5,"/Volumes/Drive/Thesis/new_data/sub14/log_files/sub14_S2_ASTrain.xls"
"521","25","75",-0.5,84,52,42,2,625,511358,512855,514252,519142,519767,47013,200,625,-0.5,"/Volumes/Drive/Thesis/new_data/sub14/log_files/sub14_S2_ASTrain.xls"
"522","26","92",-0.5,83,21,64,1,613,530753,532250,533647,538138,538751,47013,-200,613,0.5,"/Volumes/Drive/Thesis/new_data/sub14/log_files/sub14_S2_ASTrain.xls"
"523","27","83",-0.5,48,23,23,2,445,549648,551145,552542,557649,558094,47013,400,445,0.5,"/Volumes/Drive/Thesis/new_data/sub14/log_files/sub14_S2_ASTrain.xls"
"524","28","61",0.5,39,24,61,2,451,569059,570556,571953,576345,576796,47013,-300,451,0.5,"/Volumes/Drive/Thesis/new_data/sub14/log_files/sub14_S2_ASTrain.xls"
"525","29","24",0.5,61,23,82,1,474,588171,589668,591065,595656,596130,47013,-100,474,0.5,"/Volumes/Drive/Thesis/new_data/sub14/log_files/sub14_S2_ASTrain.xls"
"526","30","33",0.5,58,16,72,2,467,607682,609179,610576,614967,615434,47013,-300,467,-0.5,"/Volumes/Drive/Thesis/new_data/sub14/log_files/sub14_S2_ASTrain.xls"
"527","31","59",0.5,43,28,81,2,562,627093,628590,629987,634778,635340,47013,100,562,0.5,"/Volumes/Drive/Thesis/new_data/sub14/log_files/sub14_S2_ASTrain.xls"
"528","32","20",0.5,51,24,65,1,494,646288,647785,649182,653673,654167,47013,-200,494,0.5,"/Volumes/Drive/Thesis/new_data/sub14/log_files/sub14_S2_ASTrain.xls"
"529","33","79",-0.5,49,17,34,2,500,712971,714468,715866,720257,720757,712875,-300,500,-0.5,"/Volumes/Drive/Thesis/new_data/sub14/log_files/sub14_S2_ASTrain.xls"
"530","34","21",0.5,41,34,73,2,469,731584,733081,734478,739069,739538,712875,-100,469,0.5,"/Volumes/Drive/Thesis/new_data/sub14/log_files/sub14_S2_ASTrain.xls"
"531","35","60",0.5,34,29,53,1,858,750396,751894,753291,758397,759255,712875,400,858,0.5,"/Volumes/Drive/Thesis/new_data/sub14/log_files/sub14_S2_ASTrain.xls"
"532","36","68",-0.5,46,14,34,1,432,770506,772003,773401,778307,778739,712875,200,432,-0.5,"/Volumes/Drive/Thesis/new_data/sub14/log_files/sub14_S2_ASTrain.xls"
"533","37","88",-0.5,45,14,41,1,525,790433,791930,793327,797619,798144,712875,-400,525,0.5,"/Volumes/Drive/Thesis/new_data/sub14/log_files/sub14_S2_ASTrain.xls"
"534","38","14",0.5,48,21,71,1,577,809628,811125,812522,817113,817690,712875,-100,577,-0.5,"/Volumes/Drive/Thesis/new_data/sub14/log_files/sub14_S2_ASTrain.xls"
"535","39","13",0.5,58,21,69,2,425,828723,830220,831617,836608,837033,712875,300,425,-0.5,"/Volumes/Drive/Thesis/new_data/sub14/log_files/sub14_S2_ASTrain.xls"
"536","40","37",0.5,46,28,64,2,504,847918,849415,850812,855403,855907,712875,-100,504,-0.5,"/Volumes/Drive/Thesis/new_data/sub14/log_files/sub14_S2_ASTrain.xls"
"537","41","26",0.5,31,28,69,1,444,867479,868976,870373,874665,875109,712875,-400,444,0.5,"/Volumes/Drive/Thesis/new_data/sub14/log_files/sub14_S2_ASTrain.xls"
"538","42","126",-0.5,87,38,47,1,476,886075,887572,888969,893976,894452,712875,300,476,0.5,"/Volumes/Drive/Thesis/new_data/sub14/log_files/sub14_S2_ASTrain.xls"
"539","43","15",0.5,47,31,76,2,490,906085,907582,908979,914086,914576,712875,400,490,-0.5,"/Volumes/Drive/Thesis/new_data/sub14/log_files/sub14_S2_ASTrain.xls"
"540","44","44",0.5,43,29,74,1,897,926112,927609,929006,933896,934793,712875,200,897,-0.5,"/Volumes/Drive/Thesis/new_data/sub14/log_files/sub14_S2_ASTrain.xls"
"541","45","58",0.5,54,18,74,1,464,945723,947220,948617,953407,953871,712875,100,464,0.5,"/Volumes/Drive/Thesis/new_data/sub14/log_files/sub14_S2_ASTrain.xls"
"542","46","109",-0.5,75,26,47,2,459,965317,966814,968211,973317,973776,712875,400,459,-0.5,"/Volumes/Drive/Thesis/new_data/sub14/log_files/sub14_S2_ASTrain.xls"
"543","47","107",-0.5,81,13,78,2,500,985227,986724,988121,992712,993212,712875,-100,500,-0.5,"/Volumes/Drive/Thesis/new_data/sub14/log_files/sub14_S2_ASTrain.xls"
"544","48","35",0.5,36,17,63,2,397,1004538,1006035,1007433,1011924,1012321,712875,-200,397,-0.5,"/Volumes/Drive/Thesis/new_data/sub14/log_files/sub14_S2_ASTrain.xls"
"545","49","128",-0.5,75,27,38,1,770,1023733,1025230,1026627,1031019,1031789,712875,-300,770,0.5,"/Volumes/Drive/Thesis/new_data/sub14/log_files/sub14_S2_ASTrain.xls"
"546","51","18",0.5,32,13,47,1,507,1061142,1062639,1064036,1068327,1068834,712875,-400,507,0.5,"/Volumes/Drive/Thesis/new_data/sub14/log_files/sub14_S2_ASTrain.xls"
"547","52","51",0.5,37,25,72,2,420,1080254,1081751,1083148,1088038,1088458,712875,200,420,0.5,"/Volumes/Drive/Thesis/new_data/sub14/log_files/sub14_S2_ASTrain.xls"
"548","53","125",-0.5,75,38,39,2,423,1100164,1101661,1103058,1107549,1107972,712875,-200,423,0.5,"/Volumes/Drive/Thesis/new_data/sub14/log_files/sub14_S2_ASTrain.xls"
"549","54","1",0.5,51,23,64,2,457,1119176,1120673,1122070,1126561,1127018,712875,-200,457,-0.5,"/Volumes/Drive/Thesis/new_data/sub14/log_files/sub14_S2_ASTrain.xls"
"550","55","94",-0.5,86,35,61,1,538,1138071,1139568,1140965,1146089,1146627,712875,400,538,0.5,"/Volumes/Drive/Thesis/new_data/sub14/log_files/sub14_S2_ASTrain.xls"
"551","56","32",0.5,47,21,78,1,598,1157915,1159412,1160809,1165200,1165798,712875,-300,598,0.5,"/Volumes/Drive/Thesis/new_data/sub14/log_files/sub14_S2_ASTrain.xls"
"552","57","53",0.5,57,16,75,2,404,1177226,1178723,1180120,1185127,1185531,712875,300,404,0.5,"/Volumes/Drive/Thesis/new_data/sub14/log_files/sub14_S2_ASTrain.xls"
"553","58","42",0.5,52,19,61,1,462,1196554,1198051,1199448,1203740,1204202,712875,-400,462,-0.5,"/Volumes/Drive/Thesis/new_data/sub14/log_files/sub14_S2_ASTrain.xls"
"554","59","117",-0.5,72,29,41,2,822,1215350,1216847,1218244,1223035,1223857,712875,100,822,0.5,"/Volumes/Drive/Thesis/new_data/sub14/log_files/sub14_S2_ASTrain.xls"
"555","60","73",-0.5,83,51,34,2,454,1234562,1236059,1237456,1242246,1242700,712875,100,454,-0.5,"/Volumes/Drive/Thesis/new_data/sub14/log_files/sub14_S2_ASTrain.xls"
"556","61","84",-0.5,89,41,46,1,437,1253773,1255270,1256667,1261059,1261496,712875,-300,437,0.5,"/Volumes/Drive/Thesis/new_data/sub14/log_files/sub14_S2_ASTrain.xls"
"557","62","87",-0.5,86,24,52,1,764,1272486,1273983,1275380,1280387,1281151,712875,300,764,0.5,"/Volumes/Drive/Thesis/new_data/sub14/log_files/sub14_S2_ASTrain.xls"
"558","63","103",-0.5,73,15,68,2,446,1292013,1293510,1294908,1299798,1300244,712875,200,446,-0.5,"/Volumes/Drive/Thesis/new_data/sub14/log_files/sub14_S2_ASTrain.xls"
"559","64","70",-0.5,68,23,35,1,1210,1311707,1313204,1314602,1319392,1320602,712875,100,1210,-0.5,"/Volumes/Drive/Thesis/new_data/sub14/log_files/sub14_S2_ASTrain.xls"
"560","65","71",-0.5,67,14,51,2,491,1373251,1374748,1376145,1380437,1380928,1373188,-400,491,-0.5,"/Volumes/Drive/Thesis/new_data/sub14/log_files/sub14_S2_ASTrain.xls"
"561","66","65",-0.5,68,12,54,2,460,1391847,1393344,1394741,1399232,1399692,1373188,-200,460,-0.5,"/Volumes/Drive/Thesis/new_data/sub14/log_files/sub14_S2_ASTrain.xls"
"562","67","3",0.5,52,24,74,2,1146,1410842,1412339,1413737,1418327,1419473,1373188,-100,1146,-0.5,"/Volumes/Drive/Thesis/new_data/sub14/log_files/sub14_S2_ASTrain.xls"
"563","68","17",0.5,62,14,78,2,496,1430337,1431834,1433231,1437522,1438018,1373188,-400,496,0.5,"/Volumes/Drive/Thesis/new_data/sub14/log_files/sub14_S2_ASTrain.xls"
"564","69","97",-0.5,51,19,34,2,388,1449033,1450530,1451927,1456817,1457205,1373188,200,388,-0.5,"/Volumes/Drive/Thesis/new_data/sub14/log_files/sub14_S2_ASTrain.xls"
"565","70","85",-0.5,65,24,43,2,424,1468244,1469741,1471138,1475530,1475954,1373188,-300,424,0.5,"/Volumes/Drive/Thesis/new_data/sub14/log_files/sub14_S2_ASTrain.xls"
"566","71","57",0.5,54,19,71,2,450,1487140,1488637,1490084,1494675,1495125,1373188,-100,450,0.5,"/Volumes/Drive/Thesis/new_data/sub14/log_files/sub14_S2_ASTrain.xls"
"567","72","55",0.5,36,28,74,2,389,1506800,1508297,1509695,1514485,1514874,1373188,100,389,0.5,"/Volumes/Drive/Thesis/new_data/sub14/log_files/sub14_S2_ASTrain.xls"
"568","73","77",-0.5,86,25,71,2,469,1526511,1528008,1529405,1534295,1534764,1373188,200,469,-0.5,"/Volumes/Drive/Thesis/new_data/sub14/log_files/sub14_S2_ASTrain.xls"
"569","74","5",0.5,43,14,67,2,481,1546222,1547719,1549116,1553407,1553888,1373188,-400,481,-0.5,"/Volumes/Drive/Thesis/new_data/sub14/log_files/sub14_S2_ASTrain.xls"
"570","75","91",-0.5,74,42,42,2,353,1564718,1566215,1567612,1572003,1572356,1373188,-300,353,0.5,"/Volumes/Drive/Thesis/new_data/sub14/log_files/sub14_S2_ASTrain.xls"
"571","76","48",0.5,49,24,71,1,427,1583431,1584961,1586358,1590849,1591276,1373188,-200,427,-0.5,"/Volumes/Drive/Thesis/new_data/sub14/log_files/sub14_S2_ASTrain.xls"
"572","77","120",-0.5,71,35,46,1,651,1602958,1604455,1605852,1610859,1611510,1373188,300,651,0.5,"/Volumes/Drive/Thesis/new_data/sub14/log_files/sub14_S2_ASTrain.xls"
"573","78","22",0.5,31,23,56,1,438,1622386,1623883,1625280,1630071,1630509,1373188,100,438,0.5,"/Volumes/Drive/Thesis/new_data/sub14/log_files/sub14_S2_ASTrain.xls"
"574","79","50",0.5,49,25,72,1,382,1641897,1643394,1644791,1649798,1650180,1373188,300,382,0.5,"/Volumes/Drive/Thesis/new_data/sub14/log_files/sub14_S2_ASTrain.xls"
"575","80","110",-0.5,86,18,58,1,735,1661824,1663321,1664718,1669725,1670460,1373188,300,735,-0.5,"/Volumes/Drive/Thesis/new_data/sub14/log_files/sub14_S2_ASTrain.xls"
"576","81","46",0.5,29,14,41,1,453,1681052,1682549,1683946,1689053,1689506,1373188,400,453,-0.5,"/Volumes/Drive/Thesis/new_data/sub14/log_files/sub14_S2_ASTrain.xls"
"577","82","67",-0.5,47,13,24,1,557,1700979,1702476,1703873,1708979,1709536,1373188,400,557,-0.5,"/Volumes/Drive/Thesis/new_data/sub14/log_files/sub14_S2_ASTrain.xls"
"578","83","121",-0.5,61,24,39,2,396,1720490,1721987,1723384,1728374,1728770,1373188,300,396,0.5,"/Volumes/Drive/Thesis/new_data/sub14/log_files/sub14_S2_ASTrain.xls"
"579","84","12",0.5,62,16,68,1,512,1740184,1741681,1743078,1747569,1748081,1373188,-200,512,-0.5,"/Volumes/Drive/Thesis/new_data/sub14/log_files/sub14_S2_ASTrain.xls"
"580","85","23",0.5,64,12,78,2,451,1759379,1760876,1762273,1766864,1767315,1373188,-100,451,0.5,"/Volumes/Drive/Thesis/new_data/sub14/log_files/sub14_S2_ASTrain.xls"
"581","86","111",-0.5,65,29,38,2,1266,1778191,1779688,1781085,1785876,1787142,1373188,100,1266,-0.5,"/Volumes/Drive/Thesis/new_data/sub14/log_files/sub14_S2_ASTrain.xls"
"582","88","62",0.5,59,13,74,1,481,1816398,1817895,1819292,1824399,1824880,1373188,400,481,0.5,"/Volumes/Drive/Thesis/new_data/sub14/log_files/sub14_S2_ASTrain.xls"
"583","89","43",0.5,43,19,64,2,392,1836524,1838021,1839419,1844309,1844701,1373188,200,392,-0.5,"/Volumes/Drive/Thesis/new_data/sub14/log_files/sub14_S2_ASTrain.xls"
"584","90","86",-0.5,75,13,64,1,518,1855819,1857316,1858713,1863604,1864122,1373188,200,518,0.5,"/Volumes/Drive/Thesis/new_data/sub14/log_files/sub14_S2_ASTrain.xls"
"585","91","118",-0.5,73,27,48,1,972,1875430,1876927,1878324,1882915,1883887,1373188,-100,972,0.5,"/Volumes/Drive/Thesis/new_data/sub14/log_files/sub14_S2_ASTrain.xls"
"586","92","36",0.5,57,18,65,1,551,1894841,1896338,1897735,1902226,1902777,1373188,-200,551,-0.5,"/Volumes/Drive/Thesis/new_data/sub14/log_files/sub14_S2_ASTrain.xls"
"587","93","31",0.5,67,12,69,2,535,1913853,1915350,1916747,1921538,1922073,1373188,100,535,0.5,"/Volumes/Drive/Thesis/new_data/sub14/log_files/sub14_S2_ASTrain.xls"
"588","94","8",0.5,24,13,47,1,557,1933464,1934961,1936358,1940749,1941306,1373188,-300,557,-0.5,"/Volumes/Drive/Thesis/new_data/sub14/log_files/sub14_S2_ASTrain.xls"
"589","95","98",-0.5,62,28,32,1,773,1952875,1954372,1955769,1960876,1961649,1373188,400,773,-0.5,"/Volumes/Drive/Thesis/new_data/sub14/log_files/sub14_S2_ASTrain.xls"
"590","96","114",-0.5,82,28,52,1,953,1972502,1973999,1975397,1979788,1980741,1373188,-300,953,0.5,"/Volumes/Drive/Thesis/new_data/sub14/log_files/sub14_S2_ASTrain.xls"
"591","97","4",0.5,53,21,76,1,420,2028274,2029771,2031168,2035959,2036379,2028250,100,420,-0.5,"/Volumes/Drive/Thesis/new_data/sub14/log_files/sub14_S2_ASTrain.xls"
"592","98","104",-0.5,51,16,25,1,868,2047486,2048983,2050380,2055370,2056238,2028250,300,868,-0.5,"/Volumes/Drive/Thesis/new_data/sub14/log_files/sub14_S2_ASTrain.xls"
"593","99","106",-0.5,52,13,37,1,447,2067496,2068993,2070390,2075180,2075627,2028250,100,447,-0.5,"/Volumes/Drive/Thesis/new_data/sub14/log_files/sub14_S2_ASTrain.xls"
"594","100","99",-0.5,83,25,48,2,422,2086691,2088188,2089585,2093876,2094298,2028250,-400,422,-0.5,"/Volumes/Drive/Thesis/new_data/sub14/log_files/sub14_S2_ASTrain.xls"
"595","101","45",0.5,48,24,82,2,444,2105303,2106800,2108198,2113088,2113532,2028250,200,444,-0.5,"/Volumes/Drive/Thesis/new_data/sub14/log_files/sub14_S2_ASTrain.xls"
"596","102","27",0.5,41,17,56,2,410,2124997,2126494,2127892,2132682,2133092,2028250,100,410,0.5,"/Volumes/Drive/Thesis/new_data/sub14/log_files/sub14_S2_ASTrain.xls"
"597","103","96",-0.5,56,15,31,1,434,2144492,2145989,2147386,2151877,2152311,2028250,-200,434,0.5,"/Volumes/Drive/Thesis/new_data/sub14/log_files/sub14_S2_ASTrain.xls"
"598","104","69",-0.5,78,31,45,2,419,2164003,2165500,2166897,2171188,2171607,2028250,-400,419,-0.5,"/Volumes/Drive/Thesis/new_data/sub14/log_files/sub14_S2_ASTrain.xls"
"599","105","56",0.5,58,17,65,1,439,2182516,2184013,2185410,2190417,2190856,2028250,300,439,0.5,"/Volumes/Drive/Thesis/new_data/sub14/log_files/sub14_S2_ASTrain.xls"
"600","106","116",-0.5,53,17,46,1,980,2202542,2204039,2205437,2209828,2210808,2028250,-300,980,0.5,"/Volumes/Drive/Thesis/new_data/sub14/log_files/sub14_S2_ASTrain.xls"
"601","107","7",0.5,42,34,78,2,427,2221255,2222752,2224149,2228740,2229167,2028250,-100,427,-0.5,"/Volumes/Drive/Thesis/new_data/sub14/log_files/sub14_S2_ASTrain.xls"
"602","108","80",-0.5,59,18,31,1,465,2240400,2241897,2243294,2247685,2248150,2028250,-300,465,-0.5,"/Volumes/Drive/Thesis/new_data/sub14/log_files/sub14_S2_ASTrain.xls"
"603","109","49",0.5,39,17,58,2,447,2259811,2261308,2262705,2267296,2267743,2028250,-100,447,0.5,"/Volumes/Drive/Thesis/new_data/sub14/log_files/sub14_S2_ASTrain.xls"
"604","110","95",-0.5,68,15,51,2,460,2279106,2280603,2282000,2286391,2286851,2028250,-300,460,0.5,"/Volumes/Drive/Thesis/new_data/sub14/log_files/sub14_S2_ASTrain.xls"
"605","111","9",0.5,24,15,37,2,438,2297702,2299199,2300596,2305703,2306141,2028250,400,438,-0.5,"/Volumes/Drive/Thesis/new_data/sub14/log_files/sub14_S2_ASTrain.xls"
"606","112","108",-0.5,72,23,39,1,474,2317629,2319126,2320523,2325313,2325787,2028250,100,474,-0.5,"/Volumes/Drive/Thesis/new_data/sub14/log_files/sub14_S2_ASTrain.xls"
"607","113","124",-0.5,72,24,38,1,567,2336724,2338221,2339618,2344109,2344676,2028250,-200,567,0.5,"/Volumes/Drive/Thesis/new_data/sub14/log_files/sub14_S2_ASTrain.xls"
"608","114","93",-0.5,68,37,21,2,395,2356135,2357632,2359029,2363421,2363816,2028250,-300,395,0.5,"/Volumes/Drive/Thesis/new_data/sub14/log_files/sub14_S2_ASTrain.xls"
"609","115","52",0.5,46,27,63,1,1502,2375031,2376528,2377925,2382516,2384018,2028250,-100,1502,0.5,"/Volumes/Drive/Thesis/new_data/sub14/log_files/sub14_S2_ASTrain.xls"
"610","116","78",-0.5,79,36,53,1,494,2394342,2395839,2397236,2402226,2402720,2028250,300,494,-0.5,"/Volumes/Drive/Thesis/new_data/sub14/log_files/sub14_S2_ASTrain.xls"
"611","117","47",0.5,49,23,62,2,448,2414136,2415633,2417030,2422037,2422485,2028250,300,448,-0.5,"/Volumes/Drive/Thesis/new_data/sub14/log_files/sub14_S2_ASTrain.xls"
"612","118","30",0.5,46,32,68,1,589,2433963,2435460,2436857,2441348,2441937,2028250,-200,589,0.5,"/Volumes/Drive/Thesis/new_data/sub14/log_files/sub14_S2_ASTrain.xls"
"613","119","34",0.5,37,28,67,1,510,2452675,2454172,2455570,2460676,2461186,2028250,400,510,-0.5,"/Volumes/Drive/Thesis/new_data/sub14/log_files/sub14_S2_ASTrain.xls"
"614","120","28",0.5,52,16,78,1,826,2472186,2473683,2475081,2480187,2481013,2028250,400,826,0.5,"/Volumes/Drive/Thesis/new_data/sub14/log_files/sub14_S2_ASTrain.xls"
"615","121","54",0.5,47,35,80,1,608,2491797,2493294,2494691,2498983,2499591,2028250,-400,608,0.5,"/Volumes/Drive/Thesis/new_data/sub14/log_files/sub14_S2_ASTrain.xls"
"616","122","76",-0.5,53,21,34,1,473,2510493,2511990,2513387,2517679,2518152,2028250,-400,473,-0.5,"/Volumes/Drive/Thesis/new_data/sub14/log_files/sub14_S2_ASTrain.xls"
"617","123","2",0.5,41,23,74,1,452,2529705,2531202,2532599,2537090,2537542,2028250,-200,452,-0.5,"/Volumes/Drive/Thesis/new_data/sub14/log_files/sub14_S2_ASTrain.xls"
"618","124","39",0.5,48,27,73,2,593,2548417,2549914,2551311,2556418,2557011,2028250,400,593,-0.5,"/Volumes/Drive/Thesis/new_data/sub14/log_files/sub14_S2_ASTrain.xls"
"619","125","122",-0.5,52,14,36,1,430,2567828,2569325,2570723,2575313,2575743,2028250,-100,430,0.5,"/Volumes/Drive/Thesis/new_data/sub14/log_files/sub14_S2_ASTrain.xls"
"620","126","115",-0.5,64,25,29,2,538,2587373,2588870,2590267,2595157,2595695,2028250,200,538,0.5,"/Volumes/Drive/Thesis/new_data/sub14/log_files/sub14_S2_ASTrain.xls"
"621","127","25",0.5,61,18,69,2,489,2606983,2608480,2609878,2614768,2615257,2028250,200,489,0.5,"/Volumes/Drive/Thesis/new_data/sub14/log_files/sub14_S2_ASTrain.xls"
"622","128","89",-0.5,54,12,32,2,467,2626395,2627892,2629289,2634179,2634646,2028250,200,467,0.5,"/Volumes/Drive/Thesis/new_data/sub14/log_files/sub14_S2_ASTrain.xls"
"623","1","34",0.5,37,28,67,1,1430,19991,21488,22885,27276,28706,19970,-300,1430,-0.5,"/Volumes/Drive/Thesis/new_data/sub15/log_files/sub15_S2_ASTrain.xls"
"624","3","107",-0.5,81,13,78,2,715,58813,60310,61708,66598,67313,19970,200,715,-0.5,"/Volumes/Drive/Thesis/new_data/sub15/log_files/sub15_S2_ASTrain.xls"
"625","4","27",0.5,41,17,56,2,603,78724,80221,81618,86209,86812,19970,-100,603,0.5,"/Volumes/Drive/Thesis/new_data/sub15/log_files/sub15_S2_ASTrain.xls"
"626","6","4",0.5,53,21,76,1,667,117430,118927,120324,125331,125998,19970,300,667,-0.5,"/Volumes/Drive/Thesis/new_data/sub15/log_files/sub15_S2_ASTrain.xls"
"627","7","20",0.5,51,24,65,1,802,137357,138854,140251,144742,145544,19970,-200,802,0.5,"/Volumes/Drive/Thesis/new_data/sub15/log_files/sub15_S2_ASTrain.xls"
"628","8","50",0.5,49,25,72,1,655,156369,157866,159263,163654,164309,19970,-300,655,0.5,"/Volumes/Drive/Thesis/new_data/sub15/log_files/sub15_S2_ASTrain.xls"
"629","9","87",-0.5,86,24,52,2,713,175281,176778,178175,183282,183995,19970,400,713,0.5,"/Volumes/Drive/Thesis/new_data/sub15/log_files/sub15_S2_ASTrain.xls"
"630","10","81",-0.5,76,24,54,2,539,194908,196405,197803,202909,203448,19970,400,539,0.5,"/Volumes/Drive/Thesis/new_data/sub15/log_files/sub15_S2_ASTrain.xls"
"631","11","115",-0.5,64,25,29,2,551,214736,216233,217630,222021,222572,19970,-300,551,0.5,"/Volumes/Drive/Thesis/new_data/sub15/log_files/sub15_S2_ASTrain.xls"
"632","12","125",-0.5,75,38,39,2,742,233847,235378,236775,241266,242008,19970,-200,742,0.5,"/Volumes/Drive/Thesis/new_data/sub15/log_files/sub15_S2_ASTrain.xls"
"633","13","12",0.5,62,16,68,1,561,252776,254273,255671,259962,260523,19970,-400,561,-0.5,"/Volumes/Drive/Thesis/new_data/sub15/log_files/sub15_S2_ASTrain.xls"
"634","14","118",-0.5,73,27,48,1,1357,271872,273369,274766,279556,280913,19970,100,1357,0.5,"/Volumes/Drive/Thesis/new_data/sub15/log_files/sub15_S2_ASTrain.xls"
"635","15","39",0.5,48,27,73,2,563,290867,292364,293761,298552,299115,19970,100,563,-0.5,"/Volumes/Drive/Thesis/new_data/sub15/log_files/sub15_S2_ASTrain.xls"
"636","16","17",0.5,62,14,78,2,513,310661,312158,313555,318445,318958,19970,200,513,0.5,"/Volumes/Drive/Thesis/new_data/sub15/log_files/sub15_S2_ASTrain.xls"
"637","17","80",-0.5,59,18,31,1,556,330455,331952,333349,338339,338895,19970,300,556,-0.5,"/Volumes/Drive/Thesis/new_data/sub15/log_files/sub15_S2_ASTrain.xls"
"638","18","103",-0.5,73,15,68,2,658,349766,351263,352660,357767,358425,19970,400,658,-0.5,"/Volumes/Drive/Thesis/new_data/sub15/log_files/sub15_S2_ASTrain.xls"
"639","19","90",-0.5,74,43,41,1,578,369577,371074,372471,376862,377440,19970,-300,578,0.5,"/Volumes/Drive/Thesis/new_data/sub15/log_files/sub15_S2_ASTrain.xls"
"640","20","82",-0.5,48,14,32,1,640,388772,390269,391682,396689,397329,19970,300,640,0.5,"/Volumes/Drive/Thesis/new_data/sub15/log_files/sub15_S2_ASTrain.xls"
"641","21","64",0.5,38,14,62,1,537,408515,410012,411410,415901,416438,19970,-200,537,0.5,"/Volumes/Drive/Thesis/new_data/sub15/log_files/sub15_S2_ASTrain.xls"
"642","22","56",0.5,58,17,65,1,528,427428,428925,430322,435112,435640,19970,100,528,0.5,"/Volumes/Drive/Thesis/new_data/sub15/log_files/sub15_S2_ASTrain.xls"
"643","23","59",0.5,43,28,81,2,610,447122,448619,450016,454607,455217,19970,-100,610,0.5,"/Volumes/Drive/Thesis/new_data/sub15/log_files/sub15_S2_ASTrain.xls"
"644","24","119",-0.5,54,17,27,2,1297,466516,468013,469411,474201,475498,19970,100,1297,0.5,"/Volumes/Drive/Thesis/new_data/sub15/log_files/sub15_S2_ASTrain.xls"
"645","25","106",-0.5,52,13,37,1,591,486327,487824,489221,493812,494403,19970,-100,591,-0.5,"/Volumes/Drive/Thesis/new_data/sub15/log_files/sub15_S2_ASTrain.xls"
"646","26","5",0.5,43,14,67,2,822,505222,506719,508117,512408,513230,19970,-400,822,-0.5,"/Volumes/Drive/Thesis/new_data/sub15/log_files/sub15_S2_ASTrain.xls"
"647","27","72",-0.5,79,21,68,1,618,523736,525233,526630,531736,532354,19970,400,618,-0.5,"/Volumes/Drive/Thesis/new_data/sub15/log_files/sub15_S2_ASTrain.xls"
"648","28","76",-0.5,53,21,34,1,640,543762,545259,546656,550948,551588,19970,-400,640,-0.5,"/Volumes/Drive/Thesis/new_data/sub15/log_files/sub15_S2_ASTrain.xls"
"649","29","78",-0.5,79,36,53,1,656,562259,563756,565153,569744,570400,19970,-100,656,-0.5,"/Volumes/Drive/Thesis/new_data/sub15/log_files/sub15_S2_ASTrain.xls"
"650","30","44",0.5,43,29,74,1,1319,581171,582668,584065,588955,590274,19970,200,1319,-0.5,"/Volumes/Drive/Thesis/new_data/sub15/log_files/sub15_S2_ASTrain.xls"
"651","31","46",0.5,29,14,41,1,602,600283,601780,603177,607468,608070,19970,-400,602,-0.5,"/Volumes/Drive/Thesis/new_data/sub15/log_files/sub15_S2_ASTrain.xls"
"652","32","29",0.5,45,14,57,2,1475,618896,620393,621790,626281,627756,19970,-200,1475,0.5,"/Volumes/Drive/Thesis/new_data/sub15/log_files/sub15_S2_ASTrain.xls"
"653","33","30",0.5,46,32,68,1,704,666401,667898,669295,674285,674989,666244,300,704,0.5,"/Volumes/Drive/Thesis/new_data/sub15/log_files/sub15_S2_ASTrain.xls"
"654","34","84",-0.5,89,41,46,1,768,685612,687109,688507,692798,693566,666244,-400,768,0.5,"/Volumes/Drive/Thesis/new_data/sub15/log_files/sub15_S2_ASTrain.xls"
"655","35","40",0.5,67,15,84,1,560,704126,705623,707020,711411,711971,666244,-300,560,-0.5,"/Volumes/Drive/Thesis/new_data/sub15/log_files/sub15_S2_ASTrain.xls"
"656","36","38",0.5,39,25,74,1,852,723420,724917,726315,730806,731658,666244,-200,852,-0.5,"/Volumes/Drive/Thesis/new_data/sub15/log_files/sub15_S2_ASTrain.xls"
"657","37","104",-0.5,51,16,25,1,621,742632,744129,745526,750317,750938,666244,100,621,-0.5,"/Volumes/Drive/Thesis/new_data/sub15/log_files/sub15_S2_ASTrain.xls"
"658","38","126",-0.5,87,38,47,1,982,762343,763840,765237,770127,771109,666244,200,982,0.5,"/Volumes/Drive/Thesis/new_data/sub15/log_files/sub15_S2_ASTrain.xls"
"659","39","88",-0.5,45,14,41,1,706,782253,783750,785147,790137,790843,666244,300,706,0.5,"/Volumes/Drive/Thesis/new_data/sub15/log_files/sub15_S2_ASTrain.xls"
"660","40","86",-0.5,75,13,64,1,506,802163,803660,805057,810164,810670,666244,400,506,0.5,"/Volumes/Drive/Thesis/new_data/sub15/log_files/sub15_S2_ASTrain.xls"
"661","42","73",-0.5,83,51,34,2,607,840420,841917,843314,847905,848512,666244,-100,607,-0.5,"/Volumes/Drive/Thesis/new_data/sub15/log_files/sub15_S2_ASTrain.xls"
"662","43","16",0.5,45,34,89,1,566,859732,861229,862626,867117,867683,666244,-200,566,-0.5,"/Volumes/Drive/Thesis/new_data/sub15/log_files/sub15_S2_ASTrain.xls"
"663","44","1",0.5,51,23,64,2,850,879143,880640,882037,887144,887994,666244,400,850,-0.5,"/Volumes/Drive/Thesis/new_data/sub15/log_files/sub15_S2_ASTrain.xls"
"664","45","127",-0.5,65,27,48,2,586,899070,900567,901964,906455,907041,666244,-200,586,0.5,"/Volumes/Drive/Thesis/new_data/sub15/log_files/sub15_S2_ASTrain.xls"
"665","46","71",-0.5,67,14,51,2,1206,917782,919279,920677,925068,926274,666244,-300,1206,-0.5,"/Volumes/Drive/Thesis/new_data/sub15/log_files/sub15_S2_ASTrain.xls"
"666","48","112",-0.5,57,18,49,2,1172,955274,956771,958169,962460,963632,666244,-400,1172,-0.5,"/Volumes/Drive/Thesis/new_data/sub15/log_files/sub15_S2_ASTrain.xls"
"667","50","75",-0.5,84,52,42,2,602,993681,995178,996575,1001465,1002067,666244,200,602,-0.5,"/Volumes/Drive/Thesis/new_data/sub15/log_files/sub15_S2_ASTrain.xls"
"668","51","60",0.5,34,29,53,1,818,1012893,1014390,1015787,1020577,1021395,666244,100,818,0.5,"/Volumes/Drive/Thesis/new_data/sub15/log_files/sub15_S2_ASTrain.xls"
"669","52","58",0.5,54,18,74,1,596,1032204,1033701,1035098,1039989,1040585,666244,200,596,0.5,"/Volumes/Drive/Thesis/new_data/sub15/log_files/sub15_S2_ASTrain.xls"
"670","53","48",0.5,49,24,71,1,569,1051798,1053295,1054693,1059683,1060252,666244,300,569,-0.5,"/Volumes/Drive/Thesis/new_data/sub15/log_files/sub15_S2_ASTrain.xls"
"671","54","18",0.5,32,13,47,1,614,1071110,1072607,1074004,1078794,1079408,666244,100,614,0.5,"/Volumes/Drive/Thesis/new_data/sub15/log_files/sub15_S2_ASTrain.xls"
"672","55","63",0.5,47,24,61,2,654,1090205,1091702,1093099,1097690,1098344,666244,-100,654,0.5,"/Volumes/Drive/Thesis/new_data/sub15/log_files/sub15_S2_ASTrain.xls"
"673","56","65",-0.5,68,12,54,2,623,1109616,1111113,1112511,1117517,1118140,666244,300,623,-0.5,"/Volumes/Drive/Thesis/new_data/sub15/log_files/sub15_S2_ASTrain.xls"
"674","57","93",-0.5,68,37,21,2,492,1129144,1130641,1132038,1136429,1136921,666244,-300,492,0.5,"/Volumes/Drive/Thesis/new_data/sub15/log_files/sub15_S2_ASTrain.xls"
"675","58","7",0.5,42,34,78,2,461,1147940,1149437,1150834,1155724,1156185,666244,200,461,-0.5,"/Volumes/Drive/Thesis/new_data/sub15/log_files/sub15_S2_ASTrain.xls"
"676","59","111",-0.5,65,29,38,2,475,1167534,1169031,1170428,1174819,1175294,666244,-300,475,-0.5,"/Volumes/Drive/Thesis/new_data/sub15/log_files/sub15_S2_ASTrain.xls"
"677","60","14",0.5,48,21,71,1,539,1186929,1188426,1189823,1194613,1195152,666244,100,539,-0.5,"/Volumes/Drive/Thesis/new_data/sub15/log_files/sub15_S2_ASTrain.xls"
"678","61","25",0.5,61,18,69,2,714,1206240,1207737,1209134,1213625,1214339,666244,-200,714,0.5,"/Volumes/Drive/Thesis/new_data/sub15/log_files/sub15_S2_ASTrain.xls"
"679","62","97",-0.5,51,19,34,2,557,1225152,1226649,1228047,1233203,1233760,666244,400,557,-0.5,"/Volumes/Drive/Thesis/new_data/sub15/log_files/sub15_S2_ASTrain.xls"
"680","63","61",0.5,39,24,61,2,539,1245329,1246826,1248223,1253329,1253868,666244,400,539,0.5,"/Volumes/Drive/Thesis/new_data/sub15/log_files/sub15_S2_ASTrain.xls"
"681","64","43",0.5,43,19,64,2,567,1264956,1266453,1267850,1272441,1273008,666244,-100,567,-0.5,"/Volumes/Drive/Thesis/new_data/sub15/log_files/sub15_S2_ASTrain.xls"
"682","65","54",0.5,47,35,80,1,792,1326251,1327748,1329145,1334135,1334927,1326184,300,792,0.5,"/Volumes/Drive/Thesis/new_data/sub15/log_files/sub15_S2_ASTrain.xls"
"683","66","79",-0.5,49,17,34,2,507,1345446,1346942,1348373,1353263,1353770,1326184,200,507,-0.5,"/Volumes/Drive/Thesis/new_data/sub15/log_files/sub15_S2_ASTrain.xls"
"684","67","35",0.5,36,17,63,2,976,1364874,1366371,1367768,1372059,1373035,1326184,-400,976,-0.5,"/Volumes/Drive/Thesis/new_data/sub15/log_files/sub15_S2_ASTrain.xls"
"685","68","70",-0.5,68,23,35,1,534,1383470,1384967,1386364,1391271,1391805,1326184,200,534,-0.5,"/Volumes/Drive/Thesis/new_data/sub15/log_files/sub15_S2_ASTrain.xls"
"686","69","3",0.5,52,24,74,2,695,1403397,1404894,1406291,1410682,1411377,1326184,-300,695,-0.5,"/Volumes/Drive/Thesis/new_data/sub15/log_files/sub15_S2_ASTrain.xls"
"687","70","41",0.5,54,17,81,2,580,1422592,1424089,1425486,1430077,1430657,1326184,-100,580,-0.5,"/Volumes/Drive/Thesis/new_data/sub15/log_files/sub15_S2_ASTrain.xls"
"688","71","26",0.5,31,28,69,1,740,1442203,1443700,1445097,1449588,1450328,1326184,-200,740,0.5,"/Volumes/Drive/Thesis/new_data/sub15/log_files/sub15_S2_ASTrain.xls"
"689","72","36",0.5,57,18,65,1,584,1461414,1462911,1464308,1469415,1469999,1326184,400,584,-0.5,"/Volumes/Drive/Thesis/new_data/sub15/log_files/sub15_S2_ASTrain.xls"
"690","73","53",0.5,57,16,75,2,553,1481341,1482838,1484235,1489242,1489795,1326184,300,553,0.5,"/Volumes/Drive/Thesis/new_data/sub15/log_files/sub15_S2_ASTrain.xls"
"691","74","116",-0.5,53,17,46,1,665,1500869,1502366,1503763,1508254,1508919,1326184,-200,665,0.5,"/Volumes/Drive/Thesis/new_data/sub15/log_files/sub15_S2_ASTrain.xls"
"692","75","102",-0.5,84,35,47,1,543,1519781,1521278,1522675,1527782,1528325,1326184,400,543,-0.5,"/Volumes/Drive/Thesis/new_data/sub15/log_files/sub15_S2_ASTrain.xls"
"693","76","117",-0.5,72,29,41,2,494,1539093,1540590,1541987,1546877,1547371,1326184,200,494,0.5,"/Volumes/Drive/Thesis/new_data/sub15/log_files/sub15_S2_ASTrain.xls"
"694","77","49",0.5,39,17,58,2,471,1558886,1560383,1561781,1566571,1567042,1326184,100,471,0.5,"/Volumes/Drive/Thesis/new_data/sub15/log_files/sub15_S2_ASTrain.xls"
"695","78","99",-0.5,83,25,48,2,504,1577898,1579395,1580793,1585084,1585588,1326184,-400,504,-0.5,"/Volumes/Drive/Thesis/new_data/sub15/log_files/sub15_S2_ASTrain.xls"
"696","79","100",-0.5,74,35,49,1,962,1596511,1598008,1599405,1603797,1604759,1326184,-300,962,-0.5,"/Volumes/Drive/Thesis/new_data/sub15/log_files/sub15_S2_ASTrain.xls"
"697","80","95",-0.5,68,15,51,2,523,1615906,1617403,1618800,1623391,1623914,1326184,-100,523,0.5,"/Volumes/Drive/Thesis/new_data/sub15/log_files/sub15_S2_ASTrain.xls"
"698","81","77",-0.5,86,25,71,2,511,1635018,1636515,1637912,1642902,1643413,1326184,300,511,-0.5,"/Volumes/Drive/Thesis/new_data/sub15/log_files/sub15_S2_ASTrain.xls"
"699","82","19",0.5,34,23,67,2,759,1654712,1656209,1657606,1661997,1662756,1326184,-300,759,0.5,"/Volumes/Drive/Thesis/new_data/sub15/log_files/sub15_S2_ASTrain.xls"
"700","83","113",-0.5,82,19,65,2,1044,1674106,1675603,1677001,1681492,1682536,1326184,-200,1044,0.5,"/Volumes/Drive/Thesis/new_data/sub15/log_files/sub15_S2_ASTrain.xls"
"701","84","23",0.5,64,12,78,2,583,1693002,1694499,1695896,1700687,1701270,1326184,100,583,0.5,"/Volumes/Drive/Thesis/new_data/sub15/log_files/sub15_S2_ASTrain.xls"
"702","85","6",0.5,52,13,67,1,621,1712513,1714010,1715407,1720414,1721035,1326184,300,621,-0.5,"/Volumes/Drive/Thesis/new_data/sub15/log_files/sub15_S2_ASTrain.xls"
"703","86","89",-0.5,54,12,32,2,756,1732440,1733937,1735334,1739825,1740581,1326184,-200,756,0.5,"/Volumes/Drive/Thesis/new_data/sub15/log_files/sub15_S2_ASTrain.xls"
"704","87","45",0.5,48,24,82,2,536,1751851,1753348,1754745,1759137,1759673,1326184,-300,536,-0.5,"/Volumes/Drive/Thesis/new_data/sub15/log_files/sub15_S2_ASTrain.xls"
"705","88","51",0.5,37,25,72,2,711,1770664,1772161,1773558,1778149,1778860,1326184,-100,711,0.5,"/Volumes/Drive/Thesis/new_data/sub15/log_files/sub15_S2_ASTrain.xls"
"706","90","105",-0.5,71,24,49,2,1131,1808555,1810052,1811449,1816040,1817171,1326184,-100,1131,-0.5,"/Volumes/Drive/Thesis/new_data/sub15/log_files/sub15_S2_ASTrain.xls"
"707","91","96",-0.5,56,15,31,1,918,1827567,1829064,1830461,1834752,1835670,1326184,-400,918,0.5,"/Volumes/Drive/Thesis/new_data/sub15/log_files/sub15_S2_ASTrain.xls"
"708","92","8",0.5,24,13,47,1,708,1846180,1847677,1849074,1854180,1854888,1326184,400,708,-0.5,"/Volumes/Drive/Thesis/new_data/sub15/log_files/sub15_S2_ASTrain.xls"
"709","93","92",-0.5,83,21,64,1,834,1865791,1867288,1868685,1873475,1874309,1326184,100,834,0.5,"/Volumes/Drive/Thesis/new_data/sub15/log_files/sub15_S2_ASTrain.xls"
"710","94","66",-0.5,86,41,43,1,638,1885401,1886898,1888296,1893186,1893824,1326184,200,638,-0.5,"/Volumes/Drive/Thesis/new_data/sub15/log_files/sub15_S2_ASTrain.xls"
"711","96","32",0.5,47,21,78,1,714,1924107,1925604,1927002,1932108,1932822,1326184,400,714,0.5,"/Volumes/Drive/Thesis/new_data/sub15/log_files/sub15_S2_ASTrain.xls"
"712","97","94",-0.5,86,35,61,1,532,1977634,1979131,1980528,1984819,1985351,1977558,-400,532,0.5,"/Volumes/Drive/Thesis/new_data/sub15/log_files/sub15_S2_ASTrain.xls"
"713","98","22",0.5,31,23,56,1,703,1996646,1998143,1999540,2004131,2004834,1977558,-100,703,0.5,"/Volumes/Drive/Thesis/new_data/sub15/log_files/sub15_S2_ASTrain.xls"
"714","99","57",0.5,54,19,71,2,557,2016157,2017654,2019051,2023542,2024099,1977558,-200,557,0.5,"/Volumes/Drive/Thesis/new_data/sub15/log_files/sub15_S2_ASTrain.xls"
"715","100","85",-0.5,65,24,43,2,561,2035369,2036866,2038263,2043053,2043614,1977558,100,561,0.5,"/Volumes/Drive/Thesis/new_data/sub15/log_files/sub15_S2_ASTrain.xls"
"716","101","52",0.5,46,27,63,1,703,2055163,2056660,2058057,2062847,2063550,1977558,100,703,0.5,"/Volumes/Drive/Thesis/new_data/sub15/log_files/sub15_S2_ASTrain.xls"
"717","102","37",0.5,46,28,64,2,666,2074175,2075672,2077086,2081477,2082143,1977558,-300,666,-0.5,"/Volumes/Drive/Thesis/new_data/sub15/log_files/sub15_S2_ASTrain.xls"
"718","103","108",-0.5,72,23,39,1,531,2092804,2094301,2095698,2100189,2100720,1977558,-200,531,-0.5,"/Volumes/Drive/Thesis/new_data/sub15/log_files/sub15_S2_ASTrain.xls"
"719","104","13",0.5,58,21,69,2,621,2112032,2113529,2114927,2119817,2120438,1977558,200,621,-0.5,"/Volumes/Drive/Thesis/new_data/sub15/log_files/sub15_S2_ASTrain.xls"
"720","105","62",0.5,59,13,74,1,637,2131244,2132741,2134138,2139128,2139765,1977558,300,637,0.5,"/Volumes/Drive/Thesis/new_data/sub15/log_files/sub15_S2_ASTrain.xls"
"721","106","15",0.5,47,31,76,2,581,2151055,2152552,2153949,2158340,2158921,1977558,-300,581,-0.5,"/Volumes/Drive/Thesis/new_data/sub15/log_files/sub15_S2_ASTrain.xls"
"722","107","109",-0.5,75,26,47,2,537,2170366,2171863,2173260,2178367,2178904,1977558,400,537,-0.5,"/Volumes/Drive/Thesis/new_data/sub15/log_files/sub15_S2_ASTrain.xls"
"723","108","2",0.5,41,23,74,1,653,2189794,2191291,2192688,2197079,2197732,1977558,-300,653,-0.5,"/Volumes/Drive/Thesis/new_data/sub15/log_files/sub15_S2_ASTrain.xls"
"724","109","83",-0.5,48,23,23,2,602,2208706,2210203,2211600,2216707,2217309,1977558,400,602,0.5,"/Volumes/Drive/Thesis/new_data/sub15/log_files/sub15_S2_ASTrain.xls"
"725","110","123",-0.5,62,13,59,2,806,2228833,2230330,2231727,2236018,2236824,1977558,-400,806,0.5,"/Volumes/Drive/Thesis/new_data/sub15/log_files/sub15_S2_ASTrain.xls"
"726","111","28",0.5,52,16,78,1,631,2248144,2249641,2251038,2256145,2256776,1977558,400,631,0.5,"/Volumes/Drive/Thesis/new_data/sub15/log_files/sub15_S2_ASTrain.xls"
"727","112","74",-0.5,63,12,41,1,621,2267672,2269169,2270566,2274857,2275478,1977558,-400,621,-0.5,"/Volumes/Drive/Thesis/new_data/sub15/log_files/sub15_S2_ASTrain.xls"
"728","113","69",-0.5,78,31,45,2,480,2286883,2288381,2289778,2294169,2294649,1977558,-300,480,-0.5,"/Volumes/Drive/Thesis/new_data/sub15/log_files/sub15_S2_ASTrain.xls"
"729","114","124",-0.5,72,24,38,1,755,2305679,2307176,2308574,2313065,2313820,1977558,-200,755,0.5,"/Volumes/Drive/Thesis/new_data/sub15/log_files/sub15_S2_ASTrain.xls"
"730","115","47",0.5,49,23,62,2,575,2324991,2326488,2327885,2332775,2333350,1977558,200,575,-0.5,"/Volumes/Drive/Thesis/new_data/sub15/log_files/sub15_S2_ASTrain.xls"
"731","116","24",0.5,61,23,82,1,576,2344585,2346082,2347479,2352070,2352646,1977558,-100,576,0.5,"/Volumes/Drive/Thesis/new_data/sub15/log_files/sub15_S2_ASTrain.xls"
"732","117","55",0.5,36,28,74,2,560,2363381,2364878,2366275,2371382,2371942,1977558,400,560,0.5,"/Volumes/Drive/Thesis/new_data/sub15/log_files/sub15_S2_ASTrain.xls"
"733","118","11",0.5,61,17,76,2,690,2383491,2384988,2386385,2391408,2392098,1977558,300,690,-0.5,"/Volumes/Drive/Thesis/new_data/sub15/log_files/sub15_S2_ASTrain.xls"
"734","119","120",-0.5,71,35,46,1,1243,2403334,2404831,2406229,2411119,2412362,1977558,200,1243,0.5,"/Volumes/Drive/Thesis/new_data/sub15/log_files/sub15_S2_ASTrain.xls"
"735","120","122",-0.5,52,14,36,1,723,2423028,2424525,2425923,2430514,2431237,1977558,-100,723,0.5,"/Volumes/Drive/Thesis/new_data/sub15/log_files/sub15_S2_ASTrain.xls"
"736","121","101",-0.5,64,18,48,2,443,2442140,2443637,2445035,2450074,2450517,1977558,300,443,-0.5,"/Volumes/Drive/Thesis/new_data/sub15/log_files/sub15_S2_ASTrain.xls"
"737","122","21",0.5,41,34,73,2,534,2461485,2462982,2464379,2469170,2469704,1977558,100,534,0.5,"/Volumes/Drive/Thesis/new_data/sub15/log_files/sub15_S2_ASTrain.xls"
"738","123","91",-0.5,74,42,42,2,624,2480797,2482294,2483691,2488282,2488906,1977558,-100,624,0.5,"/Volumes/Drive/Thesis/new_data/sub15/log_files/sub15_S2_ASTrain.xls"
"739","124","33",0.5,58,16,72,2,728,2499792,2501289,2502686,2507177,2507905,1977558,-200,728,-0.5,"/Volumes/Drive/Thesis/new_data/sub15/log_files/sub15_S2_ASTrain.xls"
"740","125","67",-0.5,47,13,24,2,646,2519187,2520684,2522081,2527071,2527717,1977558,300,646,-0.5,"/Volumes/Drive/Thesis/new_data/sub15/log_files/sub15_S2_ASTrain.xls"
"741","126","68",-0.5,46,14,34,1,725,2538681,2540178,2541575,2546366,2547091,1977558,100,725,-0.5,"/Volumes/Drive/Thesis/new_data/sub15/log_files/sub15_S2_ASTrain.xls"
"742","127","98",-0.5,62,28,32,1,722,2557776,2559273,2560670,2564962,2565684,1977558,-400,722,-0.5,"/Volumes/Drive/Thesis/new_data/sub15/log_files/sub15_S2_ASTrain.xls"
"743","128","42",0.5,52,19,61,1,577,2576289,2577786,2579183,2584074,2584651,1977558,200,577,-0.5,"/Volumes/Drive/Thesis/new_data/sub15/log_files/sub15_S2_ASTrain.xls"
"744","1","21",0.5,41,34,73,2,749,25946,27443,28840,33331,34080,25798,-200,749,0.5,"/Volumes/Drive/Thesis/new_data/sub16/log_files/sub16_S2_ASTrain.xls"
"745","2","59",0.5,43,28,81,2,705,44958,46455,47852,52343,53048,25798,-200,705,0.5,"/Volumes/Drive/Thesis/new_data/sub16/log_files/sub16_S2_ASTrain.xls"
"746","3","114",-0.5,82,28,52,1,516,63871,65368,66765,71156,71672,25798,-300,516,0.5,"/Volumes/Drive/Thesis/new_data/sub16/log_files/sub16_S2_ASTrain.xls"
"747","4","98",-0.5,62,28,32,2,654,83282,84779,86176,91283,91937,25798,400,654,-0.5,"/Volumes/Drive/Thesis/new_data/sub16/log_files/sub16_S2_ASTrain.xls"
"748","5","28",0.5,52,16,78,1,415,103409,104906,106303,111193,111608,25798,200,415,0.5,"/Volumes/Drive/Thesis/new_data/sub16/log_files/sub16_S2_ASTrain.xls"
"749","6","120",-0.5,71,35,46,1,499,122521,124018,125415,130405,130904,25798,300,499,0.5,"/Volumes/Drive/Thesis/new_data/sub16/log_files/sub16_S2_ASTrain.xls"
"750","7","74",-0.5,63,12,41,1,383,141832,143329,144727,149317,149700,25798,-100,383,-0.5,"/Volumes/Drive/Thesis/new_data/sub16/log_files/sub16_S2_ASTrain.xls"
"751","8","1",0.5,51,23,64,2,412,161443,162940,164338,168928,169340,25798,-100,412,-0.5,"/Volumes/Drive/Thesis/new_data/sub16/log_files/sub16_S2_ASTrain.xls"
"752","9","87",-0.5,86,24,52,2,490,180239,181736,183134,188240,188730,25798,400,490,0.5,"/Volumes/Drive/Thesis/new_data/sub16/log_files/sub16_S2_ASTrain.xls"
"753","10","88",-0.5,45,14,41,1,425,200166,201663,203061,207851,208276,25798,100,425,0.5,"/Volumes/Drive/Thesis/new_data/sub16/log_files/sub16_S2_ASTrain.xls"
"754","11","38",0.5,39,25,74,1,400,219362,220859,222256,226547,226947,25798,-400,400,-0.5,"/Volumes/Drive/Thesis/new_data/sub16/log_files/sub16_S2_ASTrain.xls"
"755","12","102",-0.5,84,35,47,1,444,238374,239871,241268,245659,246103,25798,-300,444,-0.5,"/Volumes/Drive/Thesis/new_data/sub16/log_files/sub16_S2_ASTrain.xls"
"756","13","77",-0.5,86,25,71,2,518,256970,258467,259864,264256,264774,25798,-300,518,-0.5,"/Volumes/Drive/Thesis/new_data/sub16/log_files/sub16_S2_ASTrain.xls"
"757","14","45",0.5,48,24,82,2,433,275683,277180,278577,283684,284117,25798,400,433,-0.5,"/Volumes/Drive/Thesis/new_data/sub16/log_files/sub16_S2_ASTrain.xls"
"758","15","18",0.5,32,13,47,1,490,295311,296808,298205,303095,303585,25798,200,490,0.5,"/Volumes/Drive/Thesis/new_data/sub16/log_files/sub16_S2_ASTrain.xls"
"759","16","100",-0.5,74,35,49,1,431,314922,316419,317816,322606,323037,25798,100,431,-0.5,"/Volumes/Drive/Thesis/new_data/sub16/log_files/sub16_S2_ASTrain.xls"
"760","17","69",-0.5,78,31,45,2,538,334732,336229,337626,342217,342755,25798,-100,538,-0.5,"/Volumes/Drive/Thesis/new_data/sub16/log_files/sub16_S2_ASTrain.xls"
"761","18","113",-0.5,82,19,65,2,873,354144,355641,357038,361429,362302,25798,-300,873,0.5,"/Volumes/Drive/Thesis/new_data/sub16/log_files/sub16_S2_ASTrain.xls"
"762","19","50",0.5,49,25,72,2,630,372840,374337,375734,380624,381254,25798,200,630,0.5,"/Volumes/Drive/Thesis/new_data/sub16/log_files/sub16_S2_ASTrain.xls"
"763","20","11",0.5,61,17,76,2,496,392634,394131,395528,399820,400316,25798,-400,496,-0.5,"/Volumes/Drive/Thesis/new_data/sub16/log_files/sub16_S2_ASTrain.xls"
"764","21","35",0.5,36,17,63,2,581,411330,412827,414224,419015,419596,25798,100,581,-0.5,"/Volumes/Drive/Thesis/new_data/sub16/log_files/sub16_S2_ASTrain.xls"
"765","22","122",-0.5,52,14,36,1,505,430342,431839,433236,437528,438033,25798,-400,505,0.5,"/Volumes/Drive/Thesis/new_data/sub16/log_files/sub16_S2_ASTrain.xls"
"766","23","15",0.5,47,31,76,2,443,449454,450951,452349,457339,457782,25798,300,443,-0.5,"/Volumes/Drive/Thesis/new_data/sub16/log_files/sub16_S2_ASTrain.xls"
"767","24","66",-0.5,86,41,43,1,476,468849,470346,471743,476634,477110,25798,200,476,-0.5,"/Volumes/Drive/Thesis/new_data/sub16/log_files/sub16_S2_ASTrain.xls"
"768","25","57",0.5,54,19,71,2,649,488443,489940,491338,496444,497093,25798,400,649,0.5,"/Volumes/Drive/Thesis/new_data/sub16/log_files/sub16_S2_ASTrain.xls"
"769","26","49",0.5,39,17,58,1,1435,508071,509568,510965,515955,517390,25798,300,1435,0.5,"/Volumes/Drive/Thesis/new_data/sub16/log_files/sub16_S2_ASTrain.xls"
"770","27","101",-0.5,64,18,48,2,429,527982,529479,530876,535882,536311,25798,300,429,-0.5,"/Volumes/Drive/Thesis/new_data/sub16/log_files/sub16_S2_ASTrain.xls"
"771","28","16",0.5,45,34,89,1,424,547892,549389,550786,555277,555701,25798,-200,424,-0.5,"/Volumes/Drive/Thesis/new_data/sub16/log_files/sub16_S2_ASTrain.xls"
"772","29","23",0.5,64,12,78,2,893,566688,568185,569582,574073,574966,25798,-200,893,0.5,"/Volumes/Drive/Thesis/new_data/sub16/log_files/sub16_S2_ASTrain.xls"
"773","30","39",0.5,48,27,73,2,775,586083,587580,588977,593268,594043,25798,-400,775,-0.5,"/Volumes/Drive/Thesis/new_data/sub16/log_files/sub16_S2_ASTrain.xls"
"774","31","90",-0.5,74,43,41,1,323,604879,606376,607773,612563,612886,25798,100,323,0.5,"/Volumes/Drive/Thesis/new_data/sub16/log_files/sub16_S2_ASTrain.xls"
"775","32","92",-0.5,83,21,64,1,557,624390,625887,627284,631875,632432,25798,-100,557,0.5,"/Volumes/Drive/Thesis/new_data/sub16/log_files/sub16_S2_ASTrain.xls"
"776","33","6",0.5,52,13,67,1,414,705039,706543,707941,712531,712945,704930,-100,414,-0.5,"/Volumes/Drive/Thesis/new_data/sub16/log_files/sub16_S2_ASTrain.xls"
"777","34","7",0.5,42,34,78,2,350,724641,726138,727535,732641,732991,704930,400,350,-0.5,"/Volumes/Drive/Thesis/new_data/sub16/log_files/sub16_S2_ASTrain.xls"
"778","35","85",-0.5,65,24,43,2,461,744169,745666,747063,751654,752115,704930,-100,461,0.5,"/Volumes/Drive/Thesis/new_data/sub16/log_files/sub16_S2_ASTrain.xls"
"779","36","17",0.5,62,14,78,2,394,763164,764661,766058,770549,770943,704930,-200,394,0.5,"/Volumes/Drive/Thesis/new_data/sub16/log_files/sub16_S2_ASTrain.xls"
"780","37","95",-0.5,68,15,51,2,342,782160,783657,785054,789944,790286,704930,200,342,0.5,"/Volumes/Drive/Thesis/new_data/sub16/log_files/sub16_S2_ASTrain.xls"
"781","38","79",-0.5,49,17,34,2,655,801854,803351,804748,809239,809894,704930,-200,655,-0.5,"/Volumes/Drive/Thesis/new_data/sub16/log_files/sub16_S2_ASTrain.xls"
"782","39","46",0.5,29,14,41,1,454,820567,822064,823461,827752,828206,704930,-400,454,-0.5,"/Volumes/Drive/Thesis/new_data/sub16/log_files/sub16_S2_ASTrain.xls"
"783","40","67",-0.5,47,13,24,2,607,839579,841076,842473,846864,847471,704930,-300,607,-0.5,"/Volumes/Drive/Thesis/new_data/sub16/log_files/sub16_S2_ASTrain.xls"
"784","41","125",-0.5,75,38,39,2,840,858275,859772,861203,866193,867033,704930,300,840,0.5,"/Volumes/Drive/Thesis/new_data/sub16/log_files/sub16_S2_ASTrain.xls"
"785","42","78",-0.5,79,36,53,1,466,878219,879716,881113,885504,885970,704930,-300,466,-0.5,"/Volumes/Drive/Thesis/new_data/sub16/log_files/sub16_S2_ASTrain.xls"
"786","43","99",-0.5,83,25,48,2,464,897131,898628,900026,904317,904781,704930,-400,464,-0.5,"/Volumes/Drive/Thesis/new_data/sub16/log_files/sub16_S2_ASTrain.xls"
"787","44","20",0.5,51,24,65,1,784,916243,917740,919138,924028,924812,704930,200,784,0.5,"/Volumes/Drive/Thesis/new_data/sub16/log_files/sub16_S2_ASTrain.xls"
"788","45","63",0.5,47,24,61,2,425,935455,936952,938349,943339,943764,704930,300,425,0.5,"/Volumes/Drive/Thesis/new_data/sub16/log_files/sub16_S2_ASTrain.xls"
"789","46","103",-0.5,73,15,68,2,435,955249,956746,958143,963250,963685,704930,400,435,-0.5,"/Volumes/Drive/Thesis/new_data/sub16/log_files/sub16_S2_ASTrain.xls"
"790","47","115",-0.5,64,25,29,2,966,974577,976074,977472,982578,983544,704930,400,966,0.5,"/Volumes/Drive/Thesis/new_data/sub16/log_files/sub16_S2_ASTrain.xls"
"791","48","43",0.5,43,19,64,2,481,994405,995902,997299,1001890,1002371,704930,-100,481,-0.5,"/Volumes/Drive/Thesis/new_data/sub16/log_files/sub16_S2_ASTrain.xls"
"792","49","121",-0.5,61,24,39,2,373,1013517,1015014,1016411,1021201,1021574,704930,100,373,0.5,"/Volumes/Drive/Thesis/new_data/sub16/log_files/sub16_S2_ASTrain.xls"
"793","50","107",-0.5,81,13,78,2,538,1033327,1034824,1036222,1040613,1041151,704930,-300,538,-0.5,"/Volumes/Drive/Thesis/new_data/sub16/log_files/sub16_S2_ASTrain.xls"
"794","51","31",0.5,67,12,69,1,727,1052539,1054036,1055433,1059924,1060651,704930,-200,727,0.5,"/Volumes/Drive/Thesis/new_data/sub16/log_files/sub16_S2_ASTrain.xls"
"795","52","44",0.5,43,29,74,1,543,1071734,1073231,1074629,1079419,1079962,704930,100,543,-0.5,"/Volumes/Drive/Thesis/new_data/sub16/log_files/sub16_S2_ASTrain.xls"
"796","53","14",0.5,48,21,71,1,407,1091428,1092926,1094323,1098914,1099321,704930,-100,407,-0.5,"/Volumes/Drive/Thesis/new_data/sub16/log_files/sub16_S2_ASTrain.xls"
"797","54","58",0.5,54,18,74,1,404,1110324,1111821,1113219,1117510,1117914,704930,-400,404,0.5,"/Volumes/Drive/Thesis/new_data/sub16/log_files/sub16_S2_ASTrain.xls"
"798","55","104",-0.5,51,16,25,1,651,1128837,1130335,1131732,1136622,1137273,704930,200,651,-0.5,"/Volumes/Drive/Thesis/new_data/sub16/log_files/sub16_S2_ASTrain.xls"
"799","56","123",-0.5,62,13,59,1,412,1148049,1149546,1150944,1155235,1155647,704930,-400,412,0.5,"/Volumes/Drive/Thesis/new_data/sub16/log_files/sub16_S2_ASTrain.xls"
"800","57","51",0.5,37,25,72,2,483,1167245,1168742,1170139,1174929,1175412,704930,100,483,0.5,"/Volumes/Drive/Thesis/new_data/sub16/log_files/sub16_S2_ASTrain.xls"
"801","58","5",0.5,43,14,67,1,968,1186756,1188253,1189650,1194756,1195724,704930,400,968,-0.5,"/Volumes/Drive/Thesis/new_data/sub16/log_files/sub16_S2_ASTrain.xls"
"802","59","62",0.5,59,13,74,1,492,1206284,1207781,1209178,1214168,1214660,704930,300,492,0.5,"/Volumes/Drive/Thesis/new_data/sub16/log_files/sub16_S2_ASTrain.xls"
"803","60","81",-0.5,76,24,54,2,461,1225678,1227175,1228573,1232964,1233425,704930,-300,461,0.5,"/Volumes/Drive/Thesis/new_data/sub16/log_files/sub16_S2_ASTrain.xls"
"804","61","93",-0.5,68,37,21,1,831,1244574,1246071,1247468,1252359,1253190,704930,200,831,0.5,"/Volumes/Drive/Thesis/new_data/sub16/log_files/sub16_S2_ASTrain.xls"
"805","62","42",0.5,52,19,61,1,357,1264385,1265882,1267279,1271770,1272127,704930,-200,357,-0.5,"/Volumes/Drive/Thesis/new_data/sub16/log_files/sub16_S2_ASTrain.xls"
"806","63","76",-0.5,53,21,34,1,454,1283081,1284578,1285975,1290766,1291220,704930,100,454,-0.5,"/Volumes/Drive/Thesis/new_data/sub16/log_files/sub16_S2_ASTrain.xls"
"807","64","24",0.5,61,23,82,1,584,1302892,1304389,1305786,1310776,1311360,704930,300,584,0.5,"/Volumes/Drive/Thesis/new_data/sub16/log_files/sub16_S2_ASTrain.xls"
"808","65","13",0.5,58,21,69,2,536,1360577,1362074,1363471,1367962,1368498,1360509,-200,536,-0.5,"/Volumes/Drive/Thesis/new_data/sub16/log_files/sub16_S2_ASTrain.xls"
"809","66","37",0.5,46,28,64,2,418,1379290,1380787,1382184,1387174,1387592,1360509,300,418,-0.5,"/Volumes/Drive/Thesis/new_data/sub16/log_files/sub16_S2_ASTrain.xls"
"810","67","65",-0.5,68,12,54,2,359,1399200,1400697,1402094,1406685,1407044,1360509,-100,359,-0.5,"/Volumes/Drive/Thesis/new_data/sub16/log_files/sub16_S2_ASTrain.xls"
"811","68","3",0.5,52,24,74,2,469,1418196,1419693,1421090,1425980,1426449,1360509,200,469,-0.5,"/Volumes/Drive/Thesis/new_data/sub16/log_files/sub16_S2_ASTrain.xls"
"812","69","126",-0.5,87,38,47,1,429,1437408,1438905,1440302,1445192,1445621,1360509,200,429,0.5,"/Volumes/Drive/Thesis/new_data/sub16/log_files/sub16_S2_ASTrain.xls"
"813","70","117",-0.5,72,29,41,2,379,1456603,1458100,1459497,1464288,1464667,1360509,100,379,0.5,"/Volumes/Drive/Thesis/new_data/sub16/log_files/sub16_S2_ASTrain.xls"
"814","71","33",0.5,58,16,72,2,463,1476397,1477894,1479291,1484281,1484744,1360509,300,463,-0.5,"/Volumes/Drive/Thesis/new_data/sub16/log_files/sub16_S2_ASTrain.xls"
"815","72","94",-0.5,86,35,61,1,352,1496091,1497588,1498985,1503876,1504228,1360509,200,352,0.5,"/Volumes/Drive/Thesis/new_data/sub16/log_files/sub16_S2_ASTrain.xls"
"816","73","112",-0.5,57,18,49,1,518,1515802,1517299,1518696,1523803,1524321,1360509,400,518,-0.5,"/Volumes/Drive/Thesis/new_data/sub16/log_files/sub16_S2_ASTrain.xls"
"817","74","48",0.5,49,24,71,1,378,1535829,1537326,1538723,1543114,1543492,1360509,-300,378,-0.5,"/Volumes/Drive/Thesis/new_data/sub16/log_files/sub16_S2_ASTrain.xls"
"818","75","128",-0.5,75,27,38,1,671,1554425,1555922,1557319,1561711,1562382,1360509,-300,671,0.5,"/Volumes/Drive/Thesis/new_data/sub16/log_files/sub16_S2_ASTrain.xls"
"819","76","105",-0.5,71,24,49,2,481,1573338,1574835,1576232,1581338,1581819,1360509,400,481,-0.5,"/Volumes/Drive/Thesis/new_data/sub16/log_files/sub16_S2_ASTrain.xls"
"820","77","36",0.5,57,18,65,2,544,1593148,1594645,1596042,1600633,1601177,1360509,-100,544,-0.5,"/Volumes/Drive/Thesis/new_data/sub16/log_files/sub16_S2_ASTrain.xls"
"821","78","25",0.5,61,18,69,2,804,1612044,1613541,1614938,1619529,1620333,1360509,-100,804,0.5,"/Volumes/Drive/Thesis/new_data/sub16/log_files/sub16_S2_ASTrain.xls"
"822","79","68",-0.5,46,14,34,1,457,1631156,1632653,1634050,1638641,1639098,1360509,-100,457,-0.5,"/Volumes/Drive/Thesis/new_data/sub16/log_files/sub16_S2_ASTrain.xls"
"823","80","8",0.5,24,13,47,1,485,1650567,1652064,1653462,1657753,1658238,1360509,-400,485,-0.5,"/Volumes/Drive/Thesis/new_data/sub16/log_files/sub16_S2_ASTrain.xls"
"824","81","84",-0.5,89,41,46,1,423,1669679,1671176,1672574,1677564,1677987,1360509,300,423,0.5,"/Volumes/Drive/Thesis/new_data/sub16/log_files/sub16_S2_ASTrain.xls"
"825","83","75",-0.5,84,52,42,2,611,1709001,1710498,1711896,1716187,1716798,1360509,-400,611,-0.5,"/Volumes/Drive/Thesis/new_data/sub16/log_files/sub16_S2_ASTrain.xls"
"826","84","54",0.5,47,35,80,1,818,1727997,1729494,1730891,1735682,1736500,1360509,100,818,0.5,"/Volumes/Drive/Thesis/new_data/sub16/log_files/sub16_S2_ASTrain.xls"
"827","85","96",-0.5,56,15,31,1,417,1747807,1749305,1750702,1755692,1756109,1360509,300,417,0.5,"/Volumes/Drive/Thesis/new_data/sub16/log_files/sub16_S2_ASTrain.xls"
"828","86","116",-0.5,53,17,46,1,459,1767618,1769115,1770546,1774837,1775296,1360509,-400,459,0.5,"/Volumes/Drive/Thesis/new_data/sub16/log_files/sub16_S2_ASTrain.xls"
"829","87","27",0.5,41,17,56,2,435,1786348,1787845,1789242,1794032,1794467,1360509,100,435,0.5,"/Volumes/Drive/Thesis/new_data/sub16/log_files/sub16_S2_ASTrain.xls"
"830","88","97",-0.5,51,19,34,2,360,1805659,1807156,1808553,1813044,1813404,1360509,-200,360,-0.5,"/Volumes/Drive/Thesis/new_data/sub16/log_files/sub16_S2_ASTrain.xls"
"831","89","26",0.5,31,28,69,1,370,1825054,1826551,1827948,1832439,1832809,1360509,-200,370,0.5,"/Volumes/Drive/Thesis/new_data/sub16/log_files/sub16_S2_ASTrain.xls"
"832","90","60",0.5,34,29,53,1,630,1844565,1846062,1847459,1852350,1852980,1360509,200,630,0.5,"/Volumes/Drive/Thesis/new_data/sub16/log_files/sub16_S2_ASTrain.xls"
"833","91","82",-0.5,48,14,32,1,470,1863677,1865174,1866571,1870963,1871433,1360509,-300,470,0.5,"/Volumes/Drive/Thesis/new_data/sub16/log_files/sub16_S2_ASTrain.xls"
"834","92","108",-0.5,72,23,39,1,497,1882290,1883787,1885184,1889576,1890073,1360509,-300,497,-0.5,"/Volumes/Drive/Thesis/new_data/sub16/log_files/sub16_S2_ASTrain.xls"
"835","93","19",0.5,34,23,67,2,393,1901103,1902600,1903997,1908289,1908682,1360509,-400,393,0.5,"/Volumes/Drive/Thesis/new_data/sub16/log_files/sub16_S2_ASTrain.xls"
"836","94","53",0.5,57,16,75,2,538,1920398,1921895,1923292,1927783,1928321,1360509,-200,538,0.5,"/Volumes/Drive/Thesis/new_data/sub16/log_files/sub16_S2_ASTrain.xls"
"837","95","70",-0.5,68,23,35,1,419,1939310,1940807,1942205,1946995,1947414,1360509,100,419,-0.5,"/Volumes/Drive/Thesis/new_data/sub16/log_files/sub16_S2_ASTrain.xls"
"838","96","52",0.5,46,27,63,1,475,1958422,1959919,1961317,1966423,1966898,1360509,400,475,0.5,"/Volumes/Drive/Thesis/new_data/sub16/log_files/sub16_S2_ASTrain.xls"
"839","97","41",0.5,54,17,81,2,439,2015160,2016657,2018054,2022645,2023084,2014972,-100,439,-0.5,"/Volumes/Drive/Thesis/new_data/sub16/log_files/sub16_S2_ASTrain.xls"
"840","98","40",0.5,67,15,84,1,555,2034571,2036068,2037465,2042356,2042911,2014972,200,555,-0.5,"/Volumes/Drive/Thesis/new_data/sub16/log_files/sub16_S2_ASTrain.xls"
"841","99","111",-0.5,65,29,38,2,776,2053683,2055180,2056577,2060869,2061645,2014972,-400,776,-0.5,"/Volumes/Drive/Thesis/new_data/sub16/log_files/sub16_S2_ASTrain.xls"
"842","100","9",0.5,24,15,37,2,481,2072778,2074275,2075673,2080663,2081144,2014972,300,481,-0.5,"/Volumes/Drive/Thesis/new_data/sub16/log_files/sub16_S2_ASTrain.xls"
"843","101","29",0.5,45,14,57,2,603,2092290,2093787,2095184,2099775,2100378,2014972,-100,603,0.5,"/Volumes/Drive/Thesis/new_data/sub16/log_files/sub16_S2_ASTrain.xls"
"844","102","127",-0.5,65,27,48,2,498,2111102,2112599,2113996,2118488,2118986,2014972,-200,498,0.5,"/Volumes/Drive/Thesis/new_data/sub16/log_files/sub16_S2_ASTrain.xls"
"845","103","32",0.5,47,21,78,1,537,2130514,2132011,2133408,2138198,2138735,2014972,100,537,0.5,"/Volumes/Drive/Thesis/new_data/sub16/log_files/sub16_S2_ASTrain.xls"
"846","104","124",-0.5,72,24,38,1,482,2150324,2151821,2153252,2157643,2158125,2014972,-300,482,0.5,"/Volumes/Drive/Thesis/new_data/sub16/log_files/sub16_S2_ASTrain.xls"
"847","105","119",-0.5,54,17,27,1,476,2169669,2171166,2172563,2177055,2177531,2014972,-200,476,0.5,"/Volumes/Drive/Thesis/new_data/sub16/log_files/sub16_S2_ASTrain.xls"
"848","106","61",0.5,39,24,61,2,599,2188465,2189962,2191359,2196150,2196749,2014972,100,599,0.5,"/Volumes/Drive/Thesis/new_data/sub16/log_files/sub16_S2_ASTrain.xls"
"849","107","118",-0.5,73,27,48,1,509,2208176,2209673,2211070,2215661,2216170,2014972,-100,509,0.5,"/Volumes/Drive/Thesis/new_data/sub16/log_files/sub16_S2_ASTrain.xls"
"850","108","110",-0.5,86,18,58,1,408,2227471,2228968,2230365,2235355,2235763,2014972,300,408,-0.5,"/Volumes/Drive/Thesis/new_data/sub16/log_files/sub16_S2_ASTrain.xls"
"851","109","64",0.5,38,14,62,1,404,2246766,2248263,2249660,2253952,2254356,2014972,-400,404,0.5,"/Volumes/Drive/Thesis/new_data/sub16/log_files/sub16_S2_ASTrain.xls"
"852","110","56",0.5,58,17,65,1,420,2265479,2266976,2268373,2272764,2273184,2014972,-300,420,0.5,"/Volumes/Drive/Thesis/new_data/sub16/log_files/sub16_S2_ASTrain.xls"
"853","111","86",-0.5,75,13,64,1,411,2284424,2285922,2287319,2292209,2292620,2014972,200,411,0.5,"/Volumes/Drive/Thesis/new_data/sub16/log_files/sub16_S2_ASTrain.xls"
"854","112","55",0.5,36,28,74,2,430,2304019,2305516,2306913,2311205,2311635,2014972,-400,430,0.5,"/Volumes/Drive/Thesis/new_data/sub16/log_files/sub16_S2_ASTrain.xls"
"855","113","2",0.5,41,23,74,1,375,2322515,2324012,2325410,2330400,2330775,2014972,300,375,-0.5,"/Volumes/Drive/Thesis/new_data/sub16/log_files/sub16_S2_ASTrain.xls"
"856","114","71",-0.5,67,14,51,2,520,2341910,2343407,2344805,2349911,2350431,2014972,400,520,-0.5,"/Volumes/Drive/Thesis/new_data/sub16/log_files/sub16_S2_ASTrain.xls"
"857","115","89",-0.5,54,12,32,2,427,2362037,2363534,2364931,2369722,2370149,2014972,100,427,0.5,"/Volumes/Drive/Thesis/new_data/sub16/log_files/sub16_S2_ASTrain.xls"
"858","116","47",0.5,49,23,62,2,458,2381232,2382729,2384126,2388518,2388976,2014972,-300,458,-0.5,"/Volumes/Drive/Thesis/new_data/sub16/log_files/sub16_S2_ASTrain.xls"
"859","117","109",-0.5,75,26,47,2,457,2400328,2401825,2403222,2408112,2408569,2014972,200,457,-0.5,"/Volumes/Drive/Thesis/new_data/sub16/log_files/sub16_S2_ASTrain.xls"
"860","118","4",0.5,53,21,76,1,429,2419939,2421436,2422833,2427124,2427553,2014972,-400,429,-0.5,"/Volumes/Drive/Thesis/new_data/sub16/log_files/sub16_S2_ASTrain.xls"
"861","119","12",0.5,62,16,68,1,780,2438635,2440132,2441529,2446319,2447099,2014972,100,780,-0.5,"/Volumes/Drive/Thesis/new_data/sub16/log_files/sub16_S2_ASTrain.xls"
"862","120","83",-0.5,48,23,23,2,483,2457630,2459127,2460525,2465115,2465598,2014972,-100,483,0.5,"/Volumes/Drive/Thesis/new_data/sub16/log_files/sub16_S2_ASTrain.xls"
"863","121","30",0.5,46,32,68,1,358,2477042,2478539,2479936,2484427,2484785,2014972,-200,358,0.5,"/Volumes/Drive/Thesis/new_data/sub16/log_files/sub16_S2_ASTrain.xls"
"864","122","73",-0.5,83,51,34,2,479,2496337,2497834,2499231,2504337,2504816,2014972,400,479,-0.5,"/Volumes/Drive/Thesis/new_data/sub16/log_files/sub16_S2_ASTrain.xls"
"865","123","91",-0.5,74,42,42,2,373,2515948,2517445,2518842,2523732,2524105,2014972,200,373,0.5,"/Volumes/Drive/Thesis/new_data/sub16/log_files/sub16_S2_ASTrain.xls"
"866","124","106",-0.5,52,13,37,1,398,2535359,2536856,2538253,2542744,2543142,2014972,-200,398,-0.5,"/Volumes/Drive/Thesis/new_data/sub16/log_files/sub16_S2_ASTrain.xls"
"867","125","80",-0.5,59,18,31,1,605,2554771,2556268,2557665,2562771,2563376,2014972,400,605,-0.5,"/Volumes/Drive/Thesis/new_data/sub16/log_files/sub16_S2_ASTrain.xls"
"868","126","34",0.5,37,28,67,1,551,2574199,2575696,2577093,2582199,2582750,2014972,400,551,-0.5,"/Volumes/Drive/Thesis/new_data/sub16/log_files/sub16_S2_ASTrain.xls"
"869","127","22",0.5,31,23,56,1,368,2594325,2595822,2597220,2602210,2602578,2014972,300,368,0.5,"/Volumes/Drive/Thesis/new_data/sub16/log_files/sub16_S2_ASTrain.xls"
"870","128","72",-0.5,79,21,68,1,421,2613637,2615134,2616531,2620922,2621343,2014972,-300,421,-0.5,"/Volumes/Drive/Thesis/new_data/sub16/log_files/sub16_S2_ASTrain.xls"
"871","1","35",0.5,36,17,63,2,1075,22636,24133,25530,30121,31196,22209,-100,1075,-0.5,"/Volumes/Drive/Thesis/new_data/sub17/log_files/sub17_S2_ASTrain.xls"
"872","2","77",-0.5,86,25,71,2,1553,41532,43029,44426,49017,50570,22209,-100,1553,-0.5,"/Volumes/Drive/Thesis/new_data/sub17/log_files/sub17_S2_ASTrain.xls"
"873","3","23",0.5,64,12,78,2,690,60445,61942,63339,68130,68820,22209,100,690,0.5,"/Volumes/Drive/Thesis/new_data/sub17/log_files/sub17_S2_ASTrain.xls"
"874","4","106",-0.5,52,13,37,1,741,79441,80938,82335,87125,87866,22209,100,741,-0.5,"/Volumes/Drive/Thesis/new_data/sub17/log_files/sub17_S2_ASTrain.xls"
"875","5","31",0.5,67,12,69,2,873,98536,100033,101431,106321,107194,22209,200,873,0.5,"/Volumes/Drive/Thesis/new_data/sub17/log_files/sub17_S2_ASTrain.xls"
"876","6","46",0.5,29,14,41,1,667,118131,119628,121025,125417,126084,22209,-300,667,-0.5,"/Volumes/Drive/Thesis/new_data/sub17/log_files/sub17_S2_ASTrain.xls"
"877","7","52",0.5,46,27,63,1,536,137343,138840,140237,145344,145880,22209,400,536,0.5,"/Volumes/Drive/Thesis/new_data/sub17/log_files/sub17_S2_ASTrain.xls"
"878","8","105",-0.5,71,24,49,2,1059,157170,158668,160065,165055,166114,22209,300,1059,-0.5,"/Volumes/Drive/Thesis/new_data/sub17/log_files/sub17_S2_ASTrain.xls"
"879","9","88",-0.5,45,14,41,1,608,177164,178661,180059,184350,184958,22209,-400,608,0.5,"/Volumes/Drive/Thesis/new_data/sub17/log_files/sub17_S2_ASTrain.xls"
"880","10","21",0.5,41,34,73,2,532,196260,197757,199154,204144,204676,22209,300,532,0.5,"/Volumes/Drive/Thesis/new_data/sub17/log_files/sub17_S2_ASTrain.xls"
"881","11","115",-0.5,64,25,29,2,678,215472,216969,218366,222857,223535,22209,-200,678,0.5,"/Volumes/Drive/Thesis/new_data/sub17/log_files/sub17_S2_ASTrain.xls"
"882","12","53",0.5,57,16,75,2,600,234667,236164,237562,242153,242753,22209,-100,600,0.5,"/Volumes/Drive/Thesis/new_data/sub17/log_files/sub17_S2_ASTrain.xls"
"883","13","65",-0.5,68,12,54,2,636,254279,255776,257173,262163,262799,22209,300,636,-0.5,"/Volumes/Drive/Thesis/new_data/sub17/log_files/sub17_S2_ASTrain.xls"
"884","14","80",-0.5,59,18,31,1,580,273990,275487,276884,281375,281955,22209,-200,580,-0.5,"/Volumes/Drive/Thesis/new_data/sub17/log_files/sub17_S2_ASTrain.xls"
"885","15","126",-0.5,87,38,47,2,1413,292986,294483,295880,300870,302283,22209,300,1413,0.5,"/Volumes/Drive/Thesis/new_data/sub17/log_files/sub17_S2_ASTrain.xls"
"886","16","43",0.5,43,19,64,2,499,312397,313911,315308,319799,320298,22209,-200,499,-0.5,"/Volumes/Drive/Thesis/new_data/sub17/log_files/sub17_S2_ASTrain.xls"
"887","17","85",-0.5,65,24,43,2,582,331127,332624,334021,338512,339094,22209,-200,582,0.5,"/Volumes/Drive/Thesis/new_data/sub17/log_files/sub17_S2_ASTrain.xls"
"888","18","122",-0.5,52,14,36,1,645,350539,352036,353433,357824,358469,22209,-300,645,0.5,"/Volumes/Drive/Thesis/new_data/sub17/log_files/sub17_S2_ASTrain.xls"
"889","19","87",-0.5,86,24,52,2,574,369834,371331,372728,377519,378093,22209,100,574,0.5,"/Volumes/Drive/Thesis/new_data/sub17/log_files/sub17_S2_ASTrain.xls"
"890","20","99",-0.5,83,25,48,2,1078,389029,390526,391924,397030,398108,22209,400,1078,-0.5,"/Volumes/Drive/Thesis/new_data/sub17/log_files/sub17_S2_ASTrain.xls"
"891","21","75",-0.5,84,52,42,2,579,408641,410138,411535,415826,416405,22209,-400,579,-0.5,"/Volumes/Drive/Thesis/new_data/sub17/log_files/sub17_S2_ASTrain.xls"
"892","22","63",0.5,47,24,61,2,554,427736,429233,430630,435022,435576,22209,-300,554,0.5,"/Volumes/Drive/Thesis/new_data/sub17/log_files/sub17_S2_ASTrain.xls"
"893","23","37",0.5,46,28,64,2,598,446649,448146,449543,454650,455248,22209,400,598,-0.5,"/Volumes/Drive/Thesis/new_data/sub17/log_files/sub17_S2_ASTrain.xls"
"894","24","8",0.5,24,13,47,1,989,466776,468273,469669,474461,475450,22209,100,989,-0.5,"/Volumes/Drive/Thesis/new_data/sub17/log_files/sub17_S2_ASTrain.xls"
"895","25","117",-0.5,72,29,41,2,640,485871,487368,488766,493357,493997,22209,-100,640,0.5,"/Volumes/Drive/Thesis/new_data/sub17/log_files/sub17_S2_ASTrain.xls"
"896","26","26",0.5,31,28,69,1,769,504867,506364,507761,512868,513637,22209,400,769,0.5,"/Volumes/Drive/Thesis/new_data/sub17/log_files/sub17_S2_ASTrain.xls"
"897","27","6",0.5,52,13,67,1,707,524894,526391,527789,532679,533386,22209,200,707,-0.5,"/Volumes/Drive/Thesis/new_data/sub17/log_files/sub17_S2_ASTrain.xls"
"898","28","10",0.5,42,37,69,1,652,544689,546186,547583,551874,552526,22209,-400,652,-0.5,"/Volumes/Drive/Thesis/new_data/sub17/log_files/sub17_S2_ASTrain.xls"
"899","29","81",-0.5,76,24,54,2,543,563401,564899,566296,571186,571729,22209,200,543,0.5,"/Volumes/Drive/Thesis/new_data/sub17/log_files/sub17_S2_ASTrain.xls"
"900","30","50",0.5,49,25,72,1,742,583296,584793,586190,591080,591822,22209,200,742,0.5,"/Volumes/Drive/Thesis/new_data/sub17/log_files/sub17_S2_ASTrain.xls"
"901","31","1",0.5,51,23,64,2,714,602391,603888,605286,609577,610291,22209,-400,714,-0.5,"/Volumes/Drive/Thesis/new_data/sub17/log_files/sub17_S2_ASTrain.xls"
"902","32","109",-0.5,75,26,47,2,1191,621204,622701,624098,628490,629681,22209,-300,1191,-0.5,"/Volumes/Drive/Thesis/new_data/sub17/log_files/sub17_S2_ASTrain.xls"
"903","33","27",0.5,41,17,56,2,559,674981,676478,677876,682167,682726,674846,-400,559,0.5,"/Volumes/Drive/Thesis/new_data/sub17/log_files/sub17_S2_ASTrain.xls"
"904","34","95",-0.5,68,15,51,2,576,694177,695674,697071,701978,702554,674846,200,576,0.5,"/Volumes/Drive/Thesis/new_data/sub17/log_files/sub17_S2_ASTrain.xls"
"905","35","125",-0.5,75,38,39,2,936,713489,714986,716383,720774,721710,674846,-300,936,0.5,"/Volumes/Drive/Thesis/new_data/sub17/log_files/sub17_S2_ASTrain.xls"
"906","36","12",0.5,62,16,68,1,1423,732900,734397,735795,740286,741709,674846,-200,1423,-0.5,"/Volumes/Drive/Thesis/new_data/sub17/log_files/sub17_S2_ASTrain.xls"
"907","37","73",-0.5,83,51,34,2,707,752395,753892,755289,760080,760787,674846,100,707,-0.5,"/Volumes/Drive/Thesis/new_data/sub17/log_files/sub17_S2_ASTrain.xls"
"908","38","42",0.5,52,19,61,1,711,771690,773187,774585,779575,780286,674846,300,711,-0.5,"/Volumes/Drive/Thesis/new_data/sub17/log_files/sub17_S2_ASTrain.xls"
"909","39","114",-0.5,82,28,52,1,695,791385,792882,794279,799169,799864,674846,200,695,0.5,"/Volumes/Drive/Thesis/new_data/sub17/log_files/sub17_S2_ASTrain.xls"
"910","40","61",0.5,39,24,61,2,614,810780,812277,813674,818781,819395,674846,400,614,0.5,"/Volumes/Drive/Thesis/new_data/sub17/log_files/sub17_S2_ASTrain.xls"
"911","41","102",-0.5,84,35,47,1,682,830208,831705,833102,837494,838176,674846,-300,682,-0.5,"/Volumes/Drive/Thesis/new_data/sub17/log_files/sub17_S2_ASTrain.xls"
"912","42","86",-0.5,75,13,64,1,737,848921,850418,851815,856922,857659,674846,400,737,0.5,"/Volumes/Drive/Thesis/new_data/sub17/log_files/sub17_S2_ASTrain.xls"
"913","43","39",0.5,48,27,73,2,650,868749,870246,871643,876134,876784,674846,-200,650,-0.5,"/Volumes/Drive/Thesis/new_data/sub17/log_files/sub17_S2_ASTrain.xls"
"914","44","121",-0.5,61,24,39,2,528,888160,889657,891055,895646,896174,674846,-100,528,0.5,"/Volumes/Drive/Thesis/new_data/sub17/log_files/sub17_S2_ASTrain.xls"
"915","45","97",-0.5,51,19,34,2,597,906957,908454,909851,914858,915455,674846,300,597,-0.5,"/Volumes/Drive/Thesis/new_data/sub17/log_files/sub17_S2_ASTrain.xls"
"916","46","101",-0.5,64,18,48,2,1642,926784,928281,929678,934469,936111,674846,100,1642,-0.5,"/Volumes/Drive/Thesis/new_data/sub17/log_files/sub17_S2_ASTrain.xls"
"917","47","14",0.5,48,21,71,1,736,945979,947477,948874,953265,954001,674846,-300,736,-0.5,"/Volumes/Drive/Thesis/new_data/sub17/log_files/sub17_S2_ASTrain.xls"
"918","48","30",0.5,46,32,68,1,929,964593,966090,967487,971978,972907,674846,-200,929,0.5,"/Volumes/Drive/Thesis/new_data/sub17/log_files/sub17_S2_ASTrain.xls"
"919","49","25",0.5,61,18,69,2,1004,983289,984786,986183,991074,992078,674846,200,1004,0.5,"/Volumes/Drive/Thesis/new_data/sub17/log_files/sub17_S2_ASTrain.xls"
"920","50","49",0.5,39,17,58,2,782,1002401,1003898,1005296,1010186,1010968,674846,200,782,0.5,"/Volumes/Drive/Thesis/new_data/sub17/log_files/sub17_S2_ASTrain.xls"
"921","51","72",-0.5,79,21,68,1,801,1022029,1023526,1024924,1029714,1030515,674846,100,801,-0.5,"/Volumes/Drive/Thesis/new_data/sub17/log_files/sub17_S2_ASTrain.xls"
"922","52","124",-0.5,72,24,38,1,1444,1041241,1042738,1044136,1049242,1050686,674846,400,1444,0.5,"/Volumes/Drive/Thesis/new_data/sub17/log_files/sub17_S2_ASTrain.xls"
"923","53","111",-0.5,65,29,38,2,548,1061252,1062749,1064146,1069153,1069701,674846,300,548,-0.5,"/Volumes/Drive/Thesis/new_data/sub17/log_files/sub17_S2_ASTrain.xls"
"924","54","59",0.5,43,28,81,2,726,1081179,1082676,1084073,1088365,1089091,674846,-400,726,0.5,"/Volumes/Drive/Thesis/new_data/sub17/log_files/sub17_S2_ASTrain.xls"
"925","55","36",0.5,57,18,65,1,906,1099876,1101373,1102770,1107560,1108466,674846,100,906,-0.5,"/Volumes/Drive/Thesis/new_data/sub17/log_files/sub17_S2_ASTrain.xls"
"926","56","58",0.5,54,18,74,1,660,1119171,1120668,1122065,1127055,1127715,674846,300,660,0.5,"/Volumes/Drive/Thesis/new_data/sub17/log_files/sub17_S2_ASTrain.xls"
"927","57","15",0.5,47,31,76,2,573,1138965,1140462,1141859,1146251,1146824,674846,-300,573,-0.5,"/Volumes/Drive/Thesis/new_data/sub17/log_files/sub17_S2_ASTrain.xls"
"928","58","78",-0.5,79,36,53,1,646,1158177,1159674,1161071,1165662,1166308,674846,-100,646,-0.5,"/Volumes/Drive/Thesis/new_data/sub17/log_files/sub17_S2_ASTrain.xls"
"929","59","2",0.5,41,23,74,1,675,1177273,1178770,1180167,1184758,1185433,674846,-100,675,-0.5,"/Volumes/Drive/Thesis/new_data/sub17/log_files/sub17_S2_ASTrain.xls"
"930","60","82",-0.5,48,14,32,1,667,1196568,1198065,1199462,1203953,1204620,674846,-200,667,0.5,"/Volumes/Drive/Thesis/new_data/sub17/log_files/sub17_S2_ASTrain.xls"
"931","61","28",0.5,52,16,78,1,644,1215381,1216878,1218275,1222866,1223510,674846,-100,644,0.5,"/Volumes/Drive/Thesis/new_data/sub17/log_files/sub17_S2_ASTrain.xls"
"932","62","66",-0.5,86,41,43,1,641,1234776,1236273,1237670,1241962,1242603,674846,-400,641,-0.5,"/Volumes/Drive/Thesis/new_data/sub17/log_files/sub17_S2_ASTrain.xls"
"933","63","90",-0.5,74,43,41,1,752,1254071,1255568,1256965,1261257,1262009,674846,-400,752,0.5,"/Volumes/Drive/Thesis/new_data/sub17/log_files/sub17_S2_ASTrain.xls"
"934","64","47",0.5,49,23,62,2,651,1272684,1274181,1275579,1280685,1281336,674846,400,651,-0.5,"/Volumes/Drive/Thesis/new_data/sub17/log_files/sub17_S2_ASTrain.xls"
"935","65","104",-0.5,51,16,25,1,766,1325231,1326728,1328125,1332616,1333382,1325150,-200,766,-0.5,"/Volumes/Drive/Thesis/new_data/sub17/log_files/sub17_S2_ASTrain.xls"
"936","66","83",-0.5,48,23,23,2,625,1344043,1345541,1346938,1351928,1352553,1325150,300,625,0.5,"/Volumes/Drive/Thesis/new_data/sub17/log_files/sub17_S2_ASTrain.xls"
"937","67","4",0.5,53,21,76,1,699,1363938,1365435,1366832,1371323,1372022,1325150,-200,699,-0.5,"/Volumes/Drive/Thesis/new_data/sub17/log_files/sub17_S2_ASTrain.xls"
"938","68","45",0.5,48,24,82,2,652,1382850,1384347,1385744,1390635,1391287,1325150,200,652,-0.5,"/Volumes/Drive/Thesis/new_data/sub17/log_files/sub17_S2_ASTrain.xls"
"939","69","9",0.5,24,15,37,2,530,1402162,1403659,1405056,1409647,1410177,1325150,-100,530,-0.5,"/Volumes/Drive/Thesis/new_data/sub17/log_files/sub17_S2_ASTrain.xls"
"940","70","44",0.5,43,29,74,1,662,1421158,1422655,1424052,1428843,1429505,1325150,100,662,-0.5,"/Volumes/Drive/Thesis/new_data/sub17/log_files/sub17_S2_ASTrain.xls"
"941","71","33",0.5,58,16,72,2,571,1440453,1441950,1443347,1447839,1448410,1325150,-200,571,-0.5,"/Volumes/Drive/Thesis/new_data/sub17/log_files/sub17_S2_ASTrain.xls"
"942","72","19",0.5,34,23,67,2,714,1459965,1461462,1462859,1467649,1468363,1325150,100,714,0.5,"/Volumes/Drive/Thesis/new_data/sub17/log_files/sub17_S2_ASTrain.xls"
"943","73","76",-0.5,53,21,34,1,727,1479559,1481056,1482454,1486745,1487472,1325150,-400,727,-0.5,"/Volumes/Drive/Thesis/new_data/sub17/log_files/sub17_S2_ASTrain.xls"
"944","74","94",-0.5,86,35,61,1,555,1498056,1499553,1500950,1505541,1506096,1325150,-100,555,0.5,"/Volumes/Drive/Thesis/new_data/sub17/log_files/sub17_S2_ASTrain.xls"
"945","75","32",0.5,47,21,78,1,685,1517667,1519164,1520562,1525552,1526237,1325150,300,685,0.5,"/Volumes/Drive/Thesis/new_data/sub17/log_files/sub17_S2_ASTrain.xls"
"946","76","60",0.5,34,29,53,1,1260,1537478,1538975,1540372,1544664,1545924,1325150,-400,1260,0.5,"/Volumes/Drive/Thesis/new_data/sub17/log_files/sub17_S2_ASTrain.xls"
"947","77","48",0.5,49,24,71,1,555,1556773,1558270,1559668,1564259,1564814,1325150,-100,555,-0.5,"/Volumes/Drive/Thesis/new_data/sub17/log_files/sub17_S2_ASTrain.xls"
"948","78","89",-0.5,54,12,32,2,680,1575786,1577283,1578680,1583071,1583751,1325150,-300,680,0.5,"/Volumes/Drive/Thesis/new_data/sub17/log_files/sub17_S2_ASTrain.xls"
"949","79","11",0.5,61,17,76,2,545,1594482,1595979,1597377,1601768,1602313,1325150,-300,545,-0.5,"/Volumes/Drive/Thesis/new_data/sub17/log_files/sub17_S2_ASTrain.xls"
"950","80","79",-0.5,49,17,34,2,564,1613079,1614576,1615973,1620764,1621328,1325150,100,564,-0.5,"/Volumes/Drive/Thesis/new_data/sub17/log_files/sub17_S2_ASTrain.xls"
"951","81","13",0.5,58,21,69,2,836,1632191,1633688,1635085,1639976,1640812,1325150,200,836,-0.5,"/Volumes/Drive/Thesis/new_data/sub17/log_files/sub17_S2_ASTrain.xls"
"952","82","84",-0.5,89,41,46,1,629,1651603,1653100,1654497,1659604,1660233,1325150,400,629,0.5,"/Volumes/Drive/Thesis/new_data/sub17/log_files/sub17_S2_ASTrain.xls"
"953","83","113",-0.5,82,19,65,2,746,1671414,1672911,1674308,1678799,1679545,1325150,-200,746,0.5,"/Volumes/Drive/Thesis/new_data/sub17/log_files/sub17_S2_ASTrain.xls"
"954","84","128",-0.5,75,27,38,1,1210,1690410,1691907,1693304,1698344,1699554,1325150,300,1210,0.5,"/Volumes/Drive/Thesis/new_data/sub17/log_files/sub17_S2_ASTrain.xls"
"955","85","74",-0.5,63,12,41,1,561,1709655,1711152,1712549,1717140,1717701,1325150,-100,561,-0.5,"/Volumes/Drive/Thesis/new_data/sub17/log_files/sub17_S2_ASTrain.xls"
"956","86","103",-0.5,73,15,68,2,825,1729250,1730747,1732144,1737250,1738075,1325150,400,825,-0.5,"/Volumes/Drive/Thesis/new_data/sub17/log_files/sub17_S2_ASTrain.xls"
"957","87","110",-0.5,86,18,58,1,604,1749160,1750657,1752054,1756346,1756950,1325150,-400,604,-0.5,"/Volumes/Drive/Thesis/new_data/sub17/log_files/sub17_S2_ASTrain.xls"
"958","88","54",0.5,47,35,80,1,612,1767973,1769470,1770867,1775259,1775871,1325150,-300,612,0.5,"/Volumes/Drive/Thesis/new_data/sub17/log_files/sub17_S2_ASTrain.xls"
"959","89","71",-0.5,67,14,51,2,601,1787268,1788765,1790163,1795269,1795870,1325150,400,601,-0.5,"/Volumes/Drive/Thesis/new_data/sub17/log_files/sub17_S2_ASTrain.xls"
"960","90","64",0.5,38,14,62,1,624,1807295,1808792,1810190,1814980,1815604,1325150,100,624,0.5,"/Volumes/Drive/Thesis/new_data/sub17/log_files/sub17_S2_ASTrain.xls"
"961","91","22",0.5,31,23,56,1,997,1826790,1828287,1829685,1834076,1835073,1325150,-300,997,0.5,"/Volumes/Drive/Thesis/new_data/sub17/log_files/sub17_S2_ASTrain.xls"
"962","92","56",0.5,58,17,65,2,910,1845903,1847400,1848797,1853787,1854697,1325150,300,910,0.5,"/Volumes/Drive/Thesis/new_data/sub17/log_files/sub17_S2_ASTrain.xls"
"963","93","24",0.5,61,23,82,1,641,1865198,1866695,1868092,1872384,1873025,1325150,-400,641,0.5,"/Volumes/Drive/Thesis/new_data/sub17/log_files/sub17_S2_ASTrain.xls"
"964","94","118",-0.5,73,27,48,1,611,1883695,1885192,1886589,1891695,1892306,1325150,400,611,0.5,"/Volumes/Drive/Thesis/new_data/sub17/log_files/sub17_S2_ASTrain.xls"
"965","95","107",-0.5,81,13,78,2,968,1903505,1905002,1906400,1911290,1912258,1325150,200,968,-0.5,"/Volumes/Drive/Thesis/new_data/sub17/log_files/sub17_S2_ASTrain.xls"
"966","96","120",-0.5,71,35,46,1,657,1923316,1924813,1926211,1931101,1931758,1325150,200,657,0.5,"/Volumes/Drive/Thesis/new_data/sub17/log_files/sub17_S2_ASTrain.xls"
"967","97","93",-0.5,68,37,21,2,452,1981135,1982633,1984030,1988820,1989272,1981020,100,452,0.5,"/Volumes/Drive/Thesis/new_data/sub17/log_files/sub17_S2_ASTrain.xls"
"968","98","16",0.5,45,34,89,1,633,2000946,2002443,2003841,2008232,2008865,1981020,-300,633,-0.5,"/Volumes/Drive/Thesis/new_data/sub17/log_files/sub17_S2_ASTrain.xls"
"969","99","55",0.5,36,28,74,2,817,2019859,2021356,2022753,2027860,2028677,1981020,400,817,0.5,"/Volumes/Drive/Thesis/new_data/sub17/log_files/sub17_S2_ASTrain.xls"
"970","100","69",-0.5,78,31,45,2,590,2039786,2041283,2042681,2047571,2048161,1981020,200,590,-0.5,"/Volumes/Drive/Thesis/new_data/sub17/log_files/sub17_S2_ASTrain.xls"
"971","101","112",-0.5,57,18,49,1,969,2059082,2060579,2061976,2067082,2068051,1981020,400,969,-0.5,"/Volumes/Drive/Thesis/new_data/sub17/log_files/sub17_S2_ASTrain.xls"
"972","102","51",0.5,37,25,72,2,506,2079109,2080606,2082003,2086295,2086801,1981020,-400,506,0.5,"/Volumes/Drive/Thesis/new_data/sub17/log_files/sub17_S2_ASTrain.xls"
"973","103","62",0.5,59,13,74,1,650,2098421,2099918,2101315,2105806,2106456,1981020,-200,650,0.5,"/Volumes/Drive/Thesis/new_data/sub17/log_files/sub17_S2_ASTrain.xls"
"974","104","92",-0.5,83,21,64,1,646,2117134,2118631,2120028,2124419,2125065,1981020,-300,646,0.5,"/Volumes/Drive/Thesis/new_data/sub17/log_files/sub17_S2_ASTrain.xls"
"975","105","127",-0.5,65,27,48,2,631,2135930,2137427,2138824,2143215,2143846,1981020,-300,631,0.5,"/Volumes/Drive/Thesis/new_data/sub17/log_files/sub17_S2_ASTrain.xls"
"976","106","57",0.5,54,19,71,2,543,2154543,2156040,2157437,2161928,2162471,1981020,-200,543,0.5,"/Volumes/Drive/Thesis/new_data/sub17/log_files/sub17_S2_ASTrain.xls"
"977","107","96",-0.5,56,15,31,1,723,2173439,2174936,2176333,2180825,2181548,1981020,-200,723,0.5,"/Volumes/Drive/Thesis/new_data/sub17/log_files/sub17_S2_ASTrain.xls"
"978","108","70",-0.5,68,23,35,1,628,2192435,2193932,2195329,2199920,2200548,1981020,-100,628,-0.5,"/Volumes/Drive/Thesis/new_data/sub17/log_files/sub17_S2_ASTrain.xls"
"979","110","20",0.5,51,24,65,1,555,2230726,2232223,2233620,2238211,2238766,1981020,-100,555,0.5,"/Volumes/Drive/Thesis/new_data/sub17/log_files/sub17_S2_ASTrain.xls"
"980","111","17",0.5,62,14,78,2,524,2250337,2251834,2253232,2258022,2258546,1981020,100,524,0.5,"/Volumes/Drive/Thesis/new_data/sub17/log_files/sub17_S2_ASTrain.xls"
"981","112","67",-0.5,47,13,24,2,656,2269932,2271429,2272826,2277218,2277874,1981020,-300,656,-0.5,"/Volumes/Drive/Thesis/new_data/sub17/log_files/sub17_S2_ASTrain.xls"
"982","113","29",0.5,45,14,57,2,632,2288628,2290125,2291523,2296413,2297045,1981020,200,632,0.5,"/Volumes/Drive/Thesis/new_data/sub17/log_files/sub17_S2_ASTrain.xls"
"983","114","7",0.5,42,34,78,2,686,2308240,2309737,2311134,2315625,2316311,1981020,-200,686,-0.5,"/Volumes/Drive/Thesis/new_data/sub17/log_files/sub17_S2_ASTrain.xls"
"984","115","119",-0.5,54,17,27,2,628,2327152,2328649,2330047,2334338,2334966,1981020,-400,628,0.5,"/Volumes/Drive/Thesis/new_data/sub17/log_files/sub17_S2_ASTrain.xls"
"985","116","116",-0.5,53,17,46,1,605,2345749,2347246,2348643,2353533,2354138,1981020,200,605,0.5,"/Volumes/Drive/Thesis/new_data/sub17/log_files/sub17_S2_ASTrain.xls"
"986","117","98",-0.5,62,28,32,1,528,2365460,2366957,2368354,2373344,2373872,1981020,300,528,-0.5,"/Volumes/Drive/Thesis/new_data/sub17/log_files/sub17_S2_ASTrain.xls"
"987","118","123",-0.5,62,13,59,2,1269,2384655,2386152,2387550,2392540,2393809,1981020,300,1269,0.5,"/Volumes/Drive/Thesis/new_data/sub17/log_files/sub17_S2_ASTrain.xls"
"988","119","38",0.5,39,25,74,1,569,2404566,2406063,2407460,2412567,2413136,1981020,400,569,-0.5,"/Volumes/Drive/Thesis/new_data/sub17/log_files/sub17_S2_ASTrain.xls"
"989","120","5",0.5,43,14,67,2,829,2424194,2425691,2427088,2431979,2432808,1981020,200,829,-0.5,"/Volumes/Drive/Thesis/new_data/sub17/log_files/sub17_S2_ASTrain.xls"
"990","121","91",-0.5,74,42,42,2,583,2443789,2445286,2446683,2450974,2451557,1981020,-400,583,0.5,"/Volumes/Drive/Thesis/new_data/sub17/log_files/sub17_S2_ASTrain.xls"
"991","122","40",0.5,67,15,84,1,751,2462901,2464398,2465795,2470087,2470838,1981020,-400,751,-0.5,"/Volumes/Drive/Thesis/new_data/sub17/log_files/sub17_S2_ASTrain.xls"
"992","123","34",0.5,37,28,67,1,1106,2481514,2483011,2484425,2489216,2490322,1981020,100,1106,-0.5,"/Volumes/Drive/Thesis/new_data/sub17/log_files/sub17_S2_ASTrain.xls"
"993","124","108",-0.5,72,23,39,1,945,2501242,2502739,2504136,2509126,2510071,1981020,300,945,-0.5,"/Volumes/Drive/Thesis/new_data/sub17/log_files/sub17_S2_ASTrain.xls"
"994","125","68",-0.5,46,14,34,1,720,2520537,2522034,2523431,2528538,2529258,1981020,400,720,-0.5,"/Volumes/Drive/Thesis/new_data/sub17/log_files/sub17_S2_ASTrain.xls"
"995","126","100",-0.5,74,35,49,1,1437,2540664,2542161,2543558,2548149,2549586,1981020,-100,1437,-0.5,"/Volumes/Drive/Thesis/new_data/sub17/log_files/sub17_S2_ASTrain.xls"
"996","127","3",0.5,52,24,74,2,772,2559976,2561473,2562870,2567860,2568632,1981020,300,772,-0.5,"/Volumes/Drive/Thesis/new_data/sub17/log_files/sub17_S2_ASTrain.xls"
"997","128","41",0.5,54,17,81,2,526,2579887,2581384,2582781,2587372,2587898,1981020,-100,526,-0.5,"/Volumes/Drive/Thesis/new_data/sub17/log_files/sub17_S2_ASTrain.xls"
"998","1","54",0.5,47,35,80,1,618,22203,23700,25097,30204,30822,21840,400,618,0.5,"/Volumes/Drive/Thesis/new_data/sub18/log_files/sub18_S2_ASTrain.xls"
"999","2","28",0.5,52,16,78,1,480,41731,43228,44625,49732,50212,21840,400,480,0.5,"/Volumes/Drive/Thesis/new_data/sub18/log_files/sub18_S2_ASTrain.xls"
"1000","3","81",-0.5,76,24,54,2,541,61541,63038,64436,69326,69867,21840,200,541,0.5,"/Volumes/Drive/Thesis/new_data/sub18/log_files/sub18_S2_ASTrain.xls"
"1001","4","47",0.5,49,23,62,2,630,81452,82949,84346,88737,89367,21840,-300,630,-0.5,"/Volumes/Drive/Thesis/new_data/sub18/log_files/sub18_S2_ASTrain.xls"
"1002","5","128",-0.5,75,27,38,1,521,100247,101744,103142,108032,108553,21840,200,521,0.5,"/Volumes/Drive/Thesis/new_data/sub18/log_files/sub18_S2_ASTrain.xls"
"1003","6","64",0.5,38,14,62,1,578,120158,121655,123052,127443,128021,21840,-300,578,0.5,"/Volumes/Drive/Thesis/new_data/sub18/log_files/sub18_S2_ASTrain.xls"
"1004","7","95",-0.5,68,15,51,2,488,139053,140550,141948,146938,147426,21840,300,488,0.5,"/Volumes/Drive/Thesis/new_data/sub18/log_files/sub18_S2_ASTrain.xls"
"1005","8","18",0.5,32,13,47,2,472,158265,159762,161159,165750,166222,21840,-100,472,0.5,"/Volumes/Drive/Thesis/new_data/sub18/log_files/sub18_S2_ASTrain.xls"
"1006","9","127",-0.5,65,27,48,2,1048,177676,179173,180571,185361,186409,21840,100,1048,0.5,"/Volumes/Drive/Thesis/new_data/sub18/log_files/sub18_S2_ASTrain.xls"
"1007","10","35",0.5,36,17,63,2,1001,196988,198485,199882,204173,205174,21840,-400,1001,-0.5,"/Volumes/Drive/Thesis/new_data/sub18/log_files/sub18_S2_ASTrain.xls"
"1008","11","56",0.5,58,17,65,1,765,215601,217098,218495,222986,223751,21840,-200,765,0.5,"/Volumes/Drive/Thesis/new_data/sub18/log_files/sub18_S2_ASTrain.xls"
"1009","12","111",-0.5,65,29,38,2,1077,234313,235810,237208,241798,242875,21840,-100,1077,-0.5,"/Volumes/Drive/Thesis/new_data/sub18/log_files/sub18_S2_ASTrain.xls"
"1010","13","92",-0.5,83,21,64,1,906,253808,255305,256702,261093,261999,21840,-300,906,0.5,"/Volumes/Drive/Thesis/new_data/sub18/log_files/sub18_S2_ASTrain.xls"
"1011","14","4",0.5,53,21,76,1,714,273019,274550,275947,280238,280952,21840,-400,714,-0.5,"/Volumes/Drive/Thesis/new_data/sub18/log_files/sub18_S2_ASTrain.xls"
"1012","15","103",-0.5,73,15,68,2,770,291749,293246,294643,299134,299904,21840,-200,770,-0.5,"/Volumes/Drive/Thesis/new_data/sub18/log_files/sub18_S2_ASTrain.xls"
"1013","16","98",-0.5,62,28,32,1,680,310960,312457,313855,318645,319325,21840,100,680,-0.5,"/Volumes/Drive/Thesis/new_data/sub18/log_files/sub18_S2_ASTrain.xls"
"1014","17","48",0.5,49,24,71,1,627,330155,331652,333050,338056,338683,21840,300,627,-0.5,"/Volumes/Drive/Thesis/new_data/sub18/log_files/sub18_S2_ASTrain.xls"
"1015","18","121",-0.5,61,24,39,2,510,349467,350964,352361,357251,357761,21840,200,510,0.5,"/Volumes/Drive/Thesis/new_data/sub18/log_files/sub18_S2_ASTrain.xls"
"1016","19","14",0.5,48,21,71,1,664,369361,370858,372255,377361,378025,21840,400,664,-0.5,"/Volumes/Drive/Thesis/new_data/sub18/log_files/sub18_S2_ASTrain.xls"
"1017","20","71",-0.5,67,14,51,2,604,388689,390186,391583,395874,396478,21840,-400,604,-0.5,"/Volumes/Drive/Thesis/new_data/sub18/log_files/sub18_S2_ASTrain.xls"
"1018","21","57",0.5,54,19,71,2,941,407800,409297,410695,415286,416227,21840,-100,941,0.5,"/Volumes/Drive/Thesis/new_data/sub18/log_files/sub18_S2_ASTrain.xls"
"1019","22","94",-0.5,86,35,61,1,795,426896,428393,429790,434697,435492,21840,200,795,0.5,"/Volumes/Drive/Thesis/new_data/sub18/log_files/sub18_S2_ASTrain.xls"
"1020","23","7",0.5,42,34,78,2,662,446706,448203,449600,454391,455053,21840,100,662,-0.5,"/Volumes/Drive/Thesis/new_data/sub18/log_files/sub18_S2_ASTrain.xls"
"1021","24","32",0.5,47,21,78,1,676,466001,467498,468895,473486,474162,21840,-100,676,0.5,"/Volumes/Drive/Thesis/new_data/sub18/log_files/sub18_S2_ASTrain.xls"
"1022","25","80",-0.5,59,18,31,1,670,484897,486394,487791,492897,493567,21840,400,670,-0.5,"/Volumes/Drive/Thesis/new_data/sub18/log_files/sub18_S2_ASTrain.xls"
"1023","26","26",0.5,31,28,69,1,795,504824,506321,507718,512209,513004,21840,-200,795,0.5,"/Volumes/Drive/Thesis/new_data/sub18/log_files/sub18_S2_ASTrain.xls"
"1024","27","13",0.5,58,21,69,2,582,524019,525516,526929,531421,532003,21840,-200,582,-0.5,"/Volumes/Drive/Thesis/new_data/sub18/log_files/sub18_S2_ASTrain.xls"
"1025","28","120",-0.5,71,35,46,1,755,543447,544944,546341,550732,551487,21840,-300,755,0.5,"/Volumes/Drive/Thesis/new_data/sub18/log_files/sub18_S2_ASTrain.xls"
"1026","29","77",-0.5,86,25,71,2,726,562558,564055,565453,569744,570470,21840,-400,726,-0.5,"/Volumes/Drive/Thesis/new_data/sub18/log_files/sub18_S2_ASTrain.xls"
"1027","30","33",0.5,58,16,72,2,690,581753,583250,584648,589638,590328,21840,300,690,-0.5,"/Volumes/Drive/Thesis/new_data/sub18/log_files/sub18_S2_ASTrain.xls"
"1028","31","75",-0.5,84,52,42,2,554,601763,603261,604658,609664,610218,21840,300,554,-0.5,"/Volumes/Drive/Thesis/new_data/sub18/log_files/sub18_S2_ASTrain.xls"
"1029","32","99",-0.5,83,25,48,2,613,621092,622589,623986,628776,629389,21840,100,613,-0.5,"/Volumes/Drive/Thesis/new_data/sub18/log_files/sub18_S2_ASTrain.xls"
"1030","33","85",-0.5,65,24,43,2,494,702679,704176,705573,710563,711057,702632,300,494,0.5,"/Volumes/Drive/Thesis/new_data/sub18/log_files/sub18_S2_ASTrain.xls"
"1031","34","8",0.5,24,13,47,1,958,722173,723670,725067,729958,730916,702632,200,958,-0.5,"/Volumes/Drive/Thesis/new_data/sub18/log_files/sub18_S2_ASTrain.xls"
"1032","35","86",-0.5,75,13,64,1,718,741368,742865,744263,749369,750087,702632,400,718,0.5,"/Volumes/Drive/Thesis/new_data/sub18/log_files/sub18_S2_ASTrain.xls"
"1033","36","46",0.5,29,14,41,1,690,761195,762692,764090,768880,769570,702632,100,690,-0.5,"/Volumes/Drive/Thesis/new_data/sub18/log_files/sub18_S2_ASTrain.xls"
"1034","37","112",-0.5,57,18,49,1,640,780806,782303,783701,787992,788632,702632,-400,640,-0.5,"/Volumes/Drive/Thesis/new_data/sub18/log_files/sub18_S2_ASTrain.xls"
"1035","38","60",0.5,34,29,53,1,891,799918,801415,802812,807303,808194,702632,-200,891,0.5,"/Volumes/Drive/Thesis/new_data/sub18/log_files/sub18_S2_ASTrain.xls"
"1036","39","124",-0.5,72,24,38,1,788,819113,820610,822007,827014,827802,702632,300,788,0.5,"/Volumes/Drive/Thesis/new_data/sub18/log_files/sub18_S2_ASTrain.xls"
"1037","40","102",-0.5,84,35,47,1,931,838541,840038,841435,846542,847473,702632,400,931,-0.5,"/Volumes/Drive/Thesis/new_data/sub18/log_files/sub18_S2_ASTrain.xls"
"1038","41","3",0.5,52,24,74,2,562,857869,859366,860763,865770,866332,702632,300,562,-0.5,"/Volumes/Drive/Thesis/new_data/sub18/log_files/sub18_S2_ASTrain.xls"
"1039","42","79",-0.5,49,17,34,2,566,877879,879376,880774,885265,885831,702632,-200,566,-0.5,"/Volumes/Drive/Thesis/new_data/sub18/log_files/sub18_S2_ASTrain.xls"
"1040","43","67",-0.5,47,13,24,2,777,896891,898388,899802,904193,904970,702632,-300,777,-0.5,"/Volumes/Drive/Thesis/new_data/sub18/log_files/sub18_S2_ASTrain.xls"
"1041","44","87",-0.5,86,24,52,2,606,915604,917101,918498,922989,923595,702632,-200,606,0.5,"/Volumes/Drive/Thesis/new_data/sub18/log_files/sub18_S2_ASTrain.xls"
"1042","45","109",-0.5,75,26,47,2,461,934416,935913,937311,941602,942063,702632,-400,461,-0.5,"/Volumes/Drive/Thesis/new_data/sub18/log_files/sub18_S2_ASTrain.xls"
"1043","46","55",0.5,36,28,74,2,554,952913,954410,955807,960914,961468,702632,400,554,0.5,"/Volumes/Drive/Thesis/new_data/sub18/log_files/sub18_S2_ASTrain.xls"
"1044","47","118",-0.5,73,27,48,1,998,972441,973938,975335,980125,981123,702632,100,998,0.5,"/Volumes/Drive/Thesis/new_data/sub18/log_files/sub18_S2_ASTrain.xls"
"1045","48","61",0.5,39,24,61,2,553,991552,993050,994447,999038,999591,702632,-100,553,0.5,"/Volumes/Drive/Thesis/new_data/sub18/log_files/sub18_S2_ASTrain.xls"
"1046","49","25",0.5,61,18,69,2,781,1010565,1012062,1013459,1017950,1018731,702632,-200,781,0.5,"/Volumes/Drive/Thesis/new_data/sub18/log_files/sub18_S2_ASTrain.xls"
"1047","50","100",-0.5,74,35,49,1,635,1029577,1031074,1032471,1037361,1037996,702632,200,635,-0.5,"/Volumes/Drive/Thesis/new_data/sub18/log_files/sub18_S2_ASTrain.xls"
"1048","51","21",0.5,41,34,73,2,1073,1049188,1050685,1052082,1057188,1058261,702632,400,1073,0.5,"/Volumes/Drive/Thesis/new_data/sub18/log_files/sub18_S2_ASTrain.xls"
"1049","52","24",0.5,61,23,82,1,529,1068499,1069996,1071393,1076184,1076713,702632,100,529,0.5,"/Volumes/Drive/Thesis/new_data/sub18/log_files/sub18_S2_ASTrain.xls"
"1050","53","10",0.5,42,37,69,1,628,1088193,1089690,1091087,1095678,1096306,702632,-100,628,-0.5,"/Volumes/Drive/Thesis/new_data/sub18/log_files/sub18_S2_ASTrain.xls"
"1051","54","37",0.5,46,28,64,2,470,1107488,1108985,1110382,1115272,1115742,702632,200,470,-0.5,"/Volumes/Drive/Thesis/new_data/sub18/log_files/sub18_S2_ASTrain.xls"
"1052","55","20",0.5,51,24,65,1,593,1127199,1128696,1130093,1134883,1135476,702632,100,593,0.5,"/Volumes/Drive/Thesis/new_data/sub18/log_files/sub18_S2_ASTrain.xls"
"1053","56","52",0.5,46,27,63,1,692,1146194,1147691,1149088,1154095,1154787,702632,300,692,0.5,"/Volumes/Drive/Thesis/new_data/sub18/log_files/sub18_S2_ASTrain.xls"
"1054","57","113",-0.5,82,19,65,2,817,1165705,1167202,1168599,1172891,1173708,702632,-400,817,0.5,"/Volumes/Drive/Thesis/new_data/sub18/log_files/sub18_S2_ASTrain.xls"
"1055","58","40",0.5,67,15,84,1,521,1184917,1186414,1187811,1192202,1192723,702632,-300,521,-0.5,"/Volumes/Drive/Thesis/new_data/sub18/log_files/sub18_S2_ASTrain.xls"
"1056","59","84",-0.5,89,41,46,1,693,1204328,1205825,1207222,1211514,1212207,702632,-400,693,0.5,"/Volumes/Drive/Thesis/new_data/sub18/log_files/sub18_S2_ASTrain.xls"
"1057","60","119",-0.5,54,17,27,2,627,1223623,1225120,1226517,1231407,1232034,702632,200,627,0.5,"/Volumes/Drive/Thesis/new_data/sub18/log_files/sub18_S2_ASTrain.xls"
"1058","61","41",0.5,54,17,81,2,484,1243516,1245013,1246411,1251002,1251486,702632,-100,484,-0.5,"/Volumes/Drive/Thesis/new_data/sub18/log_files/sub18_S2_ASTrain.xls"
"1059","62","68",-0.5,46,14,34,1,610,1263028,1264525,1265922,1270313,1270923,702632,-300,610,-0.5,"/Volumes/Drive/Thesis/new_data/sub18/log_files/sub18_S2_ASTrain.xls"
"1060","63","76",-0.5,53,21,34,1,1136,1282223,1283720,1285117,1289708,1290844,702632,-100,1136,-0.5,"/Volumes/Drive/Thesis/new_data/sub18/log_files/sub18_S2_ASTrain.xls"
"1061","64","9",0.5,24,15,37,2,715,1301734,1303231,1304628,1309019,1309734,702632,-300,715,-0.5,"/Volumes/Drive/Thesis/new_data/sub18/log_files/sub18_S2_ASTrain.xls"
"1062","65","16",0.5,45,34,89,1,514,1362013,1363510,1364908,1370014,1370528,1361972,400,514,-0.5,"/Volumes/Drive/Thesis/new_data/sub18/log_files/sub18_S2_ASTrain.xls"
"1063","66","91",-0.5,74,42,42,2,711,1381524,1383021,1384419,1388910,1389621,1361972,-200,711,0.5,"/Volumes/Drive/Thesis/new_data/sub18/log_files/sub18_S2_ASTrain.xls"
"1064","67","83",-0.5,48,23,23,2,550,1400919,1402416,1403813,1408304,1408854,1361972,-200,550,0.5,"/Volumes/Drive/Thesis/new_data/sub18/log_files/sub18_S2_ASTrain.xls"
"1065","68","49",0.5,39,17,58,2,486,1419831,1421328,1422726,1427117,1427603,1361972,-300,486,0.5,"/Volumes/Drive/Thesis/new_data/sub18/log_files/sub18_S2_ASTrain.xls"
"1066","69","5",0.5,43,14,67,2,601,1438644,1440141,1441538,1445830,1446431,1361972,-400,601,-0.5,"/Volumes/Drive/Thesis/new_data/sub18/log_files/sub18_S2_ASTrain.xls"
"1067","70","126",-0.5,87,38,47,1,566,1457157,1458654,1460051,1464442,1465008,1361972,-300,566,0.5,"/Volumes/Drive/Thesis/new_data/sub18/log_files/sub18_S2_ASTrain.xls"
"1068","71","117",-0.5,72,29,41,2,573,1476369,1477866,1479263,1484153,1484726,1361972,200,573,0.5,"/Volumes/Drive/Thesis/new_data/sub18/log_files/sub18_S2_ASTrain.xls"
"1069","72","2",0.5,41,23,74,1,575,1495780,1497277,1498674,1503681,1504256,1361972,300,575,-0.5,"/Volumes/Drive/Thesis/new_data/sub18/log_files/sub18_S2_ASTrain.xls"
"1070","73","44",0.5,43,29,74,1,541,1515690,1517187,1518584,1523574,1524115,1361972,300,541,-0.5,"/Volumes/Drive/Thesis/new_data/sub18/log_files/sub18_S2_ASTrain.xls"
"1071","74","19",0.5,34,23,67,2,629,1535484,1536981,1538378,1542969,1543598,1361972,-100,629,0.5,"/Volumes/Drive/Thesis/new_data/sub18/log_files/sub18_S2_ASTrain.xls"
"1072","75","31",0.5,67,12,69,2,493,1554280,1555777,1557174,1561964,1562457,1361972,100,493,0.5,"/Volumes/Drive/Thesis/new_data/sub18/log_files/sub18_S2_ASTrain.xls"
"1073","76","73",-0.5,83,51,34,2,527,1573475,1574972,1576369,1581476,1582003,1361972,400,527,-0.5,"/Volumes/Drive/Thesis/new_data/sub18/log_files/sub18_S2_ASTrain.xls"
"1074","77","108",-0.5,72,23,39,1,551,1592886,1594383,1595814,1600404,1600955,1361972,-100,551,-0.5,"/Volumes/Drive/Thesis/new_data/sub18/log_files/sub18_S2_ASTrain.xls"
"1075","78","6",0.5,52,13,67,1,748,1612530,1614027,1615425,1620331,1621079,1361972,200,748,-0.5,"/Volumes/Drive/Thesis/new_data/sub18/log_files/sub18_S2_ASTrain.xls"
"1076","79","50",0.5,49,25,72,1,666,1631659,1633156,1634553,1639443,1640109,1361972,200,666,0.5,"/Volumes/Drive/Thesis/new_data/sub18/log_files/sub18_S2_ASTrain.xls"
"1077","80","125",-0.5,75,38,39,2,487,1651070,1652567,1653964,1658356,1658843,1361972,-300,487,0.5,"/Volumes/Drive/Thesis/new_data/sub18/log_files/sub18_S2_ASTrain.xls"
"1078","81","66",-0.5,86,41,43,1,846,1669982,1671479,1672877,1677168,1678014,1361972,-400,846,-0.5,"/Volumes/Drive/Thesis/new_data/sub18/log_files/sub18_S2_ASTrain.xls"
"1079","82","116",-0.5,53,17,46,1,478,1689177,1690674,1692072,1696363,1696841,1361972,-400,478,0.5,"/Volumes/Drive/Thesis/new_data/sub18/log_files/sub18_S2_ASTrain.xls"
"1080","83","43",0.5,43,19,64,2,501,1708273,1709770,1711167,1715558,1716059,1361972,-300,501,-0.5,"/Volumes/Drive/Thesis/new_data/sub18/log_files/sub18_S2_ASTrain.xls"
"1081","84","27",0.5,41,17,56,2,1023,1727384,1728881,1730279,1734770,1735793,1361972,-200,1023,0.5,"/Volumes/Drive/Thesis/new_data/sub18/log_files/sub18_S2_ASTrain.xls"
"1082","85","34",0.5,37,28,67,1,1457,1746180,1747677,1749075,1753366,1754823,1361972,-400,1457,-0.5,"/Volumes/Drive/Thesis/new_data/sub18/log_files/sub18_S2_ASTrain.xls"
"1083","86","17",0.5,62,14,78,2,915,1765176,1766673,1768070,1772860,1773775,1361972,100,915,0.5,"/Volumes/Drive/Thesis/new_data/sub18/log_files/sub18_S2_ASTrain.xls"
"1084","87","53",0.5,57,16,75,2,479,1784986,1786483,1787880,1792671,1793150,1361972,100,479,0.5,"/Volumes/Drive/Thesis/new_data/sub18/log_files/sub18_S2_ASTrain.xls"
"1085","89","62",0.5,59,13,74,1,674,1823277,1824774,1826171,1831161,1831835,1361972,300,674,0.5,"/Volumes/Drive/Thesis/new_data/sub18/log_files/sub18_S2_ASTrain.xls"
"1086","90","90",-0.5,74,43,41,1,660,1842971,1844468,1845865,1850971,1851631,1361972,400,660,0.5,"/Volumes/Drive/Thesis/new_data/sub18/log_files/sub18_S2_ASTrain.xls"
"1087","91","74",-0.5,63,12,41,1,774,1862981,1864478,1865875,1870466,1871240,1361972,-100,774,-0.5,"/Volumes/Drive/Thesis/new_data/sub18/log_files/sub18_S2_ASTrain.xls"
"1088","92","97",-0.5,51,19,34,2,1367,1882275,1883806,1885203,1890309,1891676,1361972,400,1367,-0.5,"/Volumes/Drive/Thesis/new_data/sub18/log_files/sub18_S2_ASTrain.xls"
"1089","93","107",-0.5,81,13,78,2,621,1902435,1903932,1905329,1910320,1910941,1361972,300,621,-0.5,"/Volumes/Drive/Thesis/new_data/sub18/log_files/sub18_S2_ASTrain.xls"
"1090","94","69",-0.5,78,31,45,2,505,1921747,1923244,1924641,1929232,1929737,1361972,-100,505,-0.5,"/Volumes/Drive/Thesis/new_data/sub18/log_files/sub18_S2_ASTrain.xls"
"1091","95","45",0.5,48,24,82,2,603,1941358,1942855,1944252,1948743,1949346,1361972,-200,603,-0.5,"/Volumes/Drive/Thesis/new_data/sub18/log_files/sub18_S2_ASTrain.xls"
"1092","96","88",-0.5,45,14,41,1,796,1960170,1961667,1963064,1967955,1968751,1361972,200,796,0.5,"/Volumes/Drive/Thesis/new_data/sub18/log_files/sub18_S2_ASTrain.xls"
"1093","97","23",0.5,64,12,78,2,615,2026504,2028001,2029399,2034289,2034904,2026480,200,615,0.5,"/Volumes/Drive/Thesis/new_data/sub18/log_files/sub18_S2_ASTrain.xls"
"1094","98","104",-0.5,51,16,25,1,595,2045616,2047113,2048510,2052902,2053497,2026480,-300,595,-0.5,"/Volumes/Drive/Thesis/new_data/sub18/log_files/sub18_S2_ASTrain.xls"
"1095","99","12",0.5,62,16,68,1,587,2064312,2065809,2067207,2072097,2072684,2026480,200,587,-0.5,"/Volumes/Drive/Thesis/new_data/sub18/log_files/sub18_S2_ASTrain.xls"
"1096","100","123",-0.5,62,13,59,2,659,2084023,2085520,2086917,2092024,2092683,2026480,400,659,0.5,"/Volumes/Drive/Thesis/new_data/sub18/log_files/sub18_S2_ASTrain.xls"
"1097","101","115",-0.5,64,25,29,2,650,2103334,2104831,2106229,2110720,2111370,2026480,-200,650,0.5,"/Volumes/Drive/Thesis/new_data/sub18/log_files/sub18_S2_ASTrain.xls"
"1098","102","63",0.5,47,24,61,2,668,2122347,2123844,2125241,2129732,2130400,2026480,-200,668,0.5,"/Volumes/Drive/Thesis/new_data/sub18/log_files/sub18_S2_ASTrain.xls"
"1099","103","82",-0.5,48,14,32,1,701,2141858,2143355,2144752,2149542,2150243,2026480,100,701,0.5,"/Volumes/Drive/Thesis/new_data/sub18/log_files/sub18_S2_ASTrain.xls"
"1100","104","59",0.5,43,28,81,2,492,2161568,2163065,2164463,2169469,2169961,2026480,300,492,0.5,"/Volumes/Drive/Thesis/new_data/sub18/log_files/sub18_S2_ASTrain.xls"
"1101","105","15",0.5,47,31,76,2,695,2180980,2182477,2183874,2188265,2188960,2026480,-300,695,-0.5,"/Volumes/Drive/Thesis/new_data/sub18/log_files/sub18_S2_ASTrain.xls"
"1102","106","65",-0.5,68,12,54,2,673,2199676,2201173,2202570,2207161,2207834,2026480,-100,673,-0.5,"/Volumes/Drive/Thesis/new_data/sub18/log_files/sub18_S2_ASTrain.xls"
"1103","107","1",0.5,51,23,64,2,616,2218571,2220102,2221499,2226389,2227005,2026480,200,616,-0.5,"/Volumes/Drive/Thesis/new_data/sub18/log_files/sub18_S2_ASTrain.xls"
"1104","108","70",-0.5,68,23,35,1,678,2238016,2239513,2240910,2245201,2245879,2026480,-400,678,-0.5,"/Volumes/Drive/Thesis/new_data/sub18/log_files/sub18_S2_ASTrain.xls"
"1105","109","122",-0.5,52,14,36,1,788,2257111,2258608,2260005,2265012,2265800,2026480,300,788,0.5,"/Volumes/Drive/Thesis/new_data/sub18/log_files/sub18_S2_ASTrain.xls"
"1106","110","22",0.5,31,23,56,1,638,2276838,2278335,2279733,2284224,2284862,2026480,-200,638,0.5,"/Volumes/Drive/Thesis/new_data/sub18/log_files/sub18_S2_ASTrain.xls"
"1107","111","106",-0.5,52,13,37,1,743,2296349,2297846,2299244,2304134,2304877,2026480,200,743,-0.5,"/Volumes/Drive/Thesis/new_data/sub18/log_files/sub18_S2_ASTrain.xls"
"1108","112","72",-0.5,79,21,68,1,637,2315445,2316942,2318339,2323129,2323766,2026480,100,637,-0.5,"/Volumes/Drive/Thesis/new_data/sub18/log_files/sub18_S2_ASTrain.xls"
"1109","113","58",0.5,54,18,74,1,587,2334956,2336453,2337850,2342241,2342828,2026480,-300,587,0.5,"/Volumes/Drive/Thesis/new_data/sub18/log_files/sub18_S2_ASTrain.xls"
"1110","114","78",-0.5,79,36,53,1,543,2353768,2355265,2356662,2361253,2361796,2026480,-100,543,-0.5,"/Volumes/Drive/Thesis/new_data/sub18/log_files/sub18_S2_ASTrain.xls"
"1111","115","51",0.5,37,25,72,2,463,2372664,2374161,2375558,2380348,2380811,2026480,100,463,0.5,"/Volumes/Drive/Thesis/new_data/sub18/log_files/sub18_S2_ASTrain.xls"
"1112","116","38",0.5,39,25,74,1,680,2392458,2393955,2395352,2400458,2401138,2026480,400,680,-0.5,"/Volumes/Drive/Thesis/new_data/sub18/log_files/sub18_S2_ASTrain.xls"
"1113","117","42",0.5,52,19,61,1,588,2412368,2413865,2415262,2420252,2420840,2026480,300,588,-0.5,"/Volumes/Drive/Thesis/new_data/sub18/log_files/sub18_S2_ASTrain.xls"
"1114","118","114",-0.5,82,28,52,1,804,2432378,2433875,2435272,2440379,2441183,2026480,400,804,0.5,"/Volumes/Drive/Thesis/new_data/sub18/log_files/sub18_S2_ASTrain.xls"
"1115","119","89",-0.5,54,12,32,2,592,2451706,2453203,2454600,2459590,2460182,2026480,300,592,0.5,"/Volumes/Drive/Thesis/new_data/sub18/log_files/sub18_S2_ASTrain.xls"
"1116","120","110",-0.5,86,18,58,1,561,2471101,2472598,2473995,2478386,2478947,2026480,-300,561,-0.5,"/Volumes/Drive/Thesis/new_data/sub18/log_files/sub18_S2_ASTrain.xls"
"1117","121","93",-0.5,68,37,21,2,633,2489897,2491394,2492791,2497282,2497915,2026480,-200,633,0.5,"/Volumes/Drive/Thesis/new_data/sub18/log_files/sub18_S2_ASTrain.xls"
"1118","122","36",0.5,57,18,65,1,574,2509308,2510805,2512202,2516793,2517367,2026480,-100,574,-0.5,"/Volumes/Drive/Thesis/new_data/sub18/log_files/sub18_S2_ASTrain.xls"
"1119","123","30",0.5,46,32,68,1,1106,2528403,2529900,2531297,2536088,2537194,2026480,100,1106,0.5,"/Volumes/Drive/Thesis/new_data/sub18/log_files/sub18_S2_ASTrain.xls"
"1120","124","105",-0.5,71,24,49,2,703,2547914,2549411,2550808,2555100,2555803,2026480,-400,703,-0.5,"/Volumes/Drive/Thesis/new_data/sub18/log_files/sub18_S2_ASTrain.xls"
"1121","125","29",0.5,45,14,57,2,624,2566727,2568224,2569621,2573912,2574536,2026480,-400,624,0.5,"/Volumes/Drive/Thesis/new_data/sub18/log_files/sub18_S2_ASTrain.xls"
"1122","126","39",0.5,48,27,73,2,581,2585722,2587219,2588616,2592908,2593489,2026480,-400,581,-0.5,"/Volumes/Drive/Thesis/new_data/sub18/log_files/sub18_S2_ASTrain.xls"
"1123","127","96",-0.5,56,15,31,1,834,2604934,2606431,2607828,2612419,2613253,2026480,-100,834,0.5,"/Volumes/Drive/Thesis/new_data/sub18/log_files/sub18_S2_ASTrain.xls"
"1124","128","11",0.5,61,17,76,2,728,2624445,2625942,2627339,2632446,2633174,2026480,400,728,-0.5,"/Volumes/Drive/Thesis/new_data/sub18/log_files/sub18_S2_ASTrain.xls"
"1125","1","21",0.5,41,34,73,2,657,26195,27692,29089,33880,34537,26103,100,657,0.5,"/Volumes/Drive/Thesis/new_data/sub20/log_files/sub20_S2_ASTrain.xls"
"1126","2","128",-0.5,75,27,38,2,1063,45290,46787,48185,53191,54254,26103,300,1063,0.5,"/Volumes/Drive/Thesis/new_data/sub20/log_files/sub20_S2_ASTrain.xls"
"1127","3","50",0.5,49,25,72,1,921,64718,66215,67613,72004,72925,26103,-300,921,0.5,"/Volumes/Drive/Thesis/new_data/sub20/log_files/sub20_S2_ASTrain.xls"
"1128","4","123",-0.5,62,13,59,2,718,83531,85028,86425,90816,91534,26103,-300,718,0.5,"/Volumes/Drive/Thesis/new_data/sub20/log_files/sub20_S2_ASTrain.xls"
"1129","5","71",-0.5,67,14,51,2,556,102842,104339,105736,110727,111283,26103,300,556,-0.5,"/Volumes/Drive/Thesis/new_data/sub20/log_files/sub20_S2_ASTrain.xls"
"1130","6","51",0.5,37,25,72,2,882,122852,124349,125747,130853,131735,26103,400,882,0.5,"/Volumes/Drive/Thesis/new_data/sub20/log_files/sub20_S2_ASTrain.xls"
"1131","7","47",0.5,49,23,62,2,651,142680,144177,145574,149865,150516,26103,-400,651,-0.5,"/Volumes/Drive/Thesis/new_data/sub20/log_files/sub20_S2_ASTrain.xls"
"1132","8","8",0.5,24,13,47,1,511,161891,163388,164785,169676,170187,26103,200,511,-0.5,"/Volumes/Drive/Thesis/new_data/sub20/log_files/sub20_S2_ASTrain.xls"
"1133","9","38",0.5,39,25,74,1,656,181685,183182,184579,189170,189826,26103,-100,656,-0.5,"/Volumes/Drive/Thesis/new_data/sub20/log_files/sub20_S2_ASTrain.xls"
"1134","10","84",-0.5,89,41,46,2,1606,200481,201978,203375,208282,209888,26103,200,1606,0.5,"/Volumes/Drive/Thesis/new_data/sub20/log_files/sub20_S2_ASTrain.xls"
"1135","11","103",-0.5,73,15,68,2,1252,220391,221888,223285,227776,229028,26103,-200,1252,-0.5,"/Volumes/Drive/Thesis/new_data/sub20/log_files/sub20_S2_ASTrain.xls"
"1136","14","96",-0.5,56,15,31,1,560,278292,279789,281187,286293,286853,26103,400,560,0.5,"/Volumes/Drive/Thesis/new_data/sub20/log_files/sub20_S2_ASTrain.xls"
"1137","15","78",-0.5,79,36,53,1,1564,297803,299300,300698,305288,306852,26103,-100,1564,-0.5,"/Volumes/Drive/Thesis/new_data/sub20/log_files/sub20_S2_ASTrain.xls"
"1138","16","20",0.5,51,24,65,1,963,316716,318213,319610,324201,325164,26103,-100,963,0.5,"/Volumes/Drive/Thesis/new_data/sub20/log_files/sub20_S2_ASTrain.xls"
"1139","17","107",-0.5,81,13,78,2,1300,335628,337125,338522,343629,344929,26103,400,1300,-0.5,"/Volumes/Drive/Thesis/new_data/sub20/log_files/sub20_S2_ASTrain.xls"
"1140","19","105",-0.5,71,24,49,2,1192,374950,376447,377844,382235,383427,26103,-300,1192,-0.5,"/Volumes/Drive/Thesis/new_data/sub20/log_files/sub20_S2_ASTrain.xls"
"1141","20","89",-0.5,54,12,32,1,730,394145,395642,397039,401430,402160,26103,-300,730,0.5,"/Volumes/Drive/Thesis/new_data/sub20/log_files/sub20_S2_ASTrain.xls"
"1142","21","45",0.5,48,24,82,2,1089,413356,414853,416250,420742,421831,26103,-200,1089,-0.5,"/Volumes/Drive/Thesis/new_data/sub20/log_files/sub20_S2_ASTrain.xls"
"1143","22","6",0.5,52,13,67,1,500,432052,433549,434947,439737,440237,26103,100,500,-0.5,"/Volumes/Drive/Thesis/new_data/sub20/log_files/sub20_S2_ASTrain.xls"
"1144","23","102",-0.5,84,35,47,1,1297,451364,452861,454258,459048,460345,26103,100,1297,-0.5,"/Volumes/Drive/Thesis/new_data/sub20/log_files/sub20_S2_ASTrain.xls"
"1145","24","29",0.5,45,14,57,2,657,470975,472472,473869,478859,479516,26103,300,657,0.5,"/Volumes/Drive/Thesis/new_data/sub20/log_files/sub20_S2_ASTrain.xls"
"1146","25","11",0.5,61,17,76,2,623,490985,492482,493879,498470,499093,26103,-100,623,-0.5,"/Volumes/Drive/Thesis/new_data/sub20/log_files/sub20_S2_ASTrain.xls"
"1147","28","44",0.5,43,29,74,1,919,548786,550283,551680,556687,557606,26103,300,919,-0.5,"/Volumes/Drive/Thesis/new_data/sub20/log_files/sub20_S2_ASTrain.xls"
"1148","29","126",-0.5,87,38,47,1,1606,568114,569611,571008,575499,577105,26103,-200,1606,0.5,"/Volumes/Drive/Thesis/new_data/sub20/log_files/sub20_S2_ASTrain.xls"
"1149","30","49",0.5,39,17,58,2,715,586810,588307,589704,594811,595526,26103,400,715,0.5,"/Volumes/Drive/Thesis/new_data/sub20/log_files/sub20_S2_ASTrain.xls"
"1150","31","7",0.5,42,34,78,2,606,606438,607935,609332,613623,614229,26103,-400,606,-0.5,"/Volumes/Drive/Thesis/new_data/sub20/log_files/sub20_S2_ASTrain.xls"
"1151","32","31",0.5,67,12,69,1,763,624951,626448,627845,632137,632900,26103,-400,763,0.5,"/Volumes/Drive/Thesis/new_data/sub20/log_files/sub20_S2_ASTrain.xls"
"1152","33","81",-0.5,76,24,54,2,633,675051,676548,677945,682436,683069,674977,-200,633,0.5,"/Volumes/Drive/Thesis/new_data/sub20/log_files/sub20_S2_ASTrain.xls"
"1153","34","46",0.5,29,14,41,1,556,694562,696059,697456,702247,702803,674977,100,556,-0.5,"/Volumes/Drive/Thesis/new_data/sub20/log_files/sub20_S2_ASTrain.xls"
"1154","35","60",0.5,34,29,53,1,1160,714372,715869,717267,721658,722818,674977,-300,1160,0.5,"/Volumes/Drive/Thesis/new_data/sub20/log_files/sub20_S2_ASTrain.xls"
"1155","36","118",-0.5,73,27,48,2,1594,733468,734965,736362,740770,742364,674977,-300,1594,0.5,"/Volumes/Drive/Thesis/new_data/sub20/log_files/sub20_S2_ASTrain.xls"
"1156","37","83",-0.5,48,23,23,2,588,752180,753677,755075,760181,760769,674977,400,588,0.5,"/Volumes/Drive/Thesis/new_data/sub20/log_files/sub20_S2_ASTrain.xls"
"1157","38","88",-0.5,45,14,41,1,1681,771608,773105,774503,779509,781190,674977,300,1681,0.5,"/Volumes/Drive/Thesis/new_data/sub20/log_files/sub20_S2_ASTrain.xls"
"1158","39","121",-0.5,61,24,39,2,1144,791535,793032,794429,798920,800064,674977,-200,1144,0.5,"/Volumes/Drive/Thesis/new_data/sub20/log_files/sub20_S2_ASTrain.xls"
"1159","40","39",0.5,48,27,73,2,607,810531,812028,813425,817816,818423,674977,-300,607,-0.5,"/Volumes/Drive/Thesis/new_data/sub20/log_files/sub20_S2_ASTrain.xls"
"1160","41","34",0.5,37,28,67,1,972,829842,831339,832736,837028,838000,674977,-400,972,-0.5,"/Volumes/Drive/Thesis/new_data/sub20/log_files/sub20_S2_ASTrain.xls"
"1161","42","124",-0.5,72,24,38,1,1300,848854,850351,851748,856855,858155,674977,400,1300,0.5,"/Volumes/Drive/Thesis/new_data/sub20/log_files/sub20_S2_ASTrain.xls"
"1162","43","67",-0.5,47,13,24,2,619,868182,869679,871076,876067,876686,674977,300,619,-0.5,"/Volumes/Drive/Thesis/new_data/sub20/log_files/sub20_S2_ASTrain.xls"
"1163","44","4",0.5,53,21,76,1,1499,887594,889091,890488,894779,896278,674977,-400,1499,-0.5,"/Volumes/Drive/Thesis/new_data/sub20/log_files/sub20_S2_ASTrain.xls"
"1164","45","65",-0.5,68,12,54,2,880,906306,907803,909201,913991,914871,674977,100,880,-0.5,"/Volumes/Drive/Thesis/new_data/sub20/log_files/sub20_S2_ASTrain.xls"
"1165","46","14",0.5,48,21,71,1,479,925318,926815,928213,932704,933183,674977,-200,479,-0.5,"/Volumes/Drive/Thesis/new_data/sub20/log_files/sub20_S2_ASTrain.xls"
"1166","47","56",0.5,58,17,65,1,554,944813,946310,947707,952597,953151,674977,200,554,0.5,"/Volumes/Drive/Thesis/new_data/sub20/log_files/sub20_S2_ASTrain.xls"
"1167","48","97",-0.5,51,19,34,2,786,964523,966021,967418,972208,972994,674977,100,786,-0.5,"/Volumes/Drive/Thesis/new_data/sub20/log_files/sub20_S2_ASTrain.xls"
"1168","49","101",-0.5,64,18,48,2,776,984035,985532,986929,991935,992711,674977,300,776,-0.5,"/Volumes/Drive/Thesis/new_data/sub20/log_files/sub20_S2_ASTrain.xls"
"1169","50","43",0.5,43,19,64,2,554,1003745,1005242,1006639,1011031,1011585,674977,-300,554,-0.5,"/Volumes/Drive/Thesis/new_data/sub20/log_files/sub20_S2_ASTrain.xls"
"1170","51","115",-0.5,64,25,29,2,749,1022458,1023955,1025352,1030242,1030991,674977,200,749,0.5,"/Volumes/Drive/Thesis/new_data/sub20/log_files/sub20_S2_ASTrain.xls"
"1171","52","28",0.5,52,16,78,1,792,1041869,1043366,1044763,1049354,1050146,674977,-100,792,0.5,"/Volumes/Drive/Thesis/new_data/sub20/log_files/sub20_S2_ASTrain.xls"
"1172","53","25",0.5,61,18,69,2,875,1060964,1062461,1063859,1068849,1069724,674977,300,875,0.5,"/Volumes/Drive/Thesis/new_data/sub20/log_files/sub20_S2_ASTrain.xls"
"1173","54","109",-0.5,75,26,47,2,875,1080160,1081657,1083054,1088160,1089035,674977,400,875,-0.5,"/Volumes/Drive/Thesis/new_data/sub20/log_files/sub20_S2_ASTrain.xls"
"1174","56","80",-0.5,59,18,31,1,477,1119165,1120662,1122059,1126650,1127127,674977,-100,477,-0.5,"/Volumes/Drive/Thesis/new_data/sub20/log_files/sub20_S2_ASTrain.xls"
"1175","57","12",0.5,62,16,68,1,726,1138560,1140057,1141454,1146244,1146970,674977,100,726,-0.5,"/Volumes/Drive/Thesis/new_data/sub20/log_files/sub20_S2_ASTrain.xls"
"1176","58","108",-0.5,72,23,39,1,717,1157755,1159252,1160649,1164940,1165657,674977,-400,717,-0.5,"/Volumes/Drive/Thesis/new_data/sub20/log_files/sub20_S2_ASTrain.xls"
"1177","60","55",0.5,36,28,74,1,1199,1196361,1197858,1199255,1204362,1205561,674977,400,1199,0.5,"/Volumes/Drive/Thesis/new_data/sub20/log_files/sub20_S2_ASTrain.xls"
"1178","61","91",-0.5,74,42,42,2,1184,1216288,1217785,1219182,1223673,1224857,674977,-200,1184,0.5,"/Volumes/Drive/Thesis/new_data/sub20/log_files/sub20_S2_ASTrain.xls"
"1179","62","76",-0.5,53,21,34,1,470,1235200,1236697,1238094,1242386,1242856,674977,-400,470,-0.5,"/Volumes/Drive/Thesis/new_data/sub20/log_files/sub20_S2_ASTrain.xls"
"1180","63","3",0.5,52,24,74,2,1129,1254412,1255909,1257306,1261930,1263059,674977,-100,1129,-0.5,"/Volumes/Drive/Thesis/new_data/sub20/log_files/sub20_S2_ASTrain.xls"
"1181","64","23",0.5,64,12,78,2,560,1273341,1274838,1276235,1280826,1281386,674977,-100,560,0.5,"/Volumes/Drive/Thesis/new_data/sub20/log_files/sub20_S2_ASTrain.xls"
"1182","65","119",-0.5,54,17,27,2,1050,1327433,1328930,1330327,1334818,1335868,1327284,-200,1050,0.5,"/Volumes/Drive/Thesis/new_data/sub20/log_files/sub20_S2_ASTrain.xls"
"1183","66","111",-0.5,65,29,38,2,623,1346844,1348341,1349738,1354728,1355351,1327284,300,623,-0.5,"/Volumes/Drive/Thesis/new_data/sub20/log_files/sub20_S2_ASTrain.xls"
"1184","67","10",0.5,42,37,69,1,601,1366139,1367636,1369033,1374140,1374741,1327284,400,601,-0.5,"/Volumes/Drive/Thesis/new_data/sub20/log_files/sub20_S2_ASTrain.xls"
"1185","68","5",0.5,43,14,67,2,936,1385667,1387164,1388561,1393351,1394287,1327284,100,936,-0.5,"/Volumes/Drive/Thesis/new_data/sub20/log_files/sub20_S2_ASTrain.xls"
"1186","70","92",-0.5,83,21,64,1,456,1424373,1425870,1427267,1432157,1432613,1327284,200,456,0.5,"/Volumes/Drive/Thesis/new_data/sub20/log_files/sub20_S2_ASTrain.xls"
"1187","71","66",-0.5,86,41,43,1,721,1443984,1445481,1446878,1451985,1452706,1327284,400,721,-0.5,"/Volumes/Drive/Thesis/new_data/sub20/log_files/sub20_S2_ASTrain.xls"
"1188","72","48",0.5,49,24,71,1,497,1463611,1465108,1466506,1471396,1471893,1327284,200,497,-0.5,"/Volumes/Drive/Thesis/new_data/sub20/log_files/sub20_S2_ASTrain.xls"
"1189","73","114",-0.5,82,28,52,1,1230,1483305,1484802,1486200,1490990,1492220,1327284,100,1230,0.5,"/Volumes/Drive/Thesis/new_data/sub20/log_files/sub20_S2_ASTrain.xls"
"1190","75","117",-0.5,72,29,41,2,670,1521512,1523009,1524407,1528798,1529468,1327284,-300,670,0.5,"/Volumes/Drive/Thesis/new_data/sub20/log_files/sub20_S2_ASTrain.xls"
"1191","76","99",-0.5,83,25,48,1,876,1540325,1541822,1543219,1547810,1548686,1327284,-100,876,-0.5,"/Volumes/Drive/Thesis/new_data/sub20/log_files/sub20_S2_ASTrain.xls"
"1192","77","32",0.5,47,21,78,2,1032,1559221,1560718,1562115,1567122,1568154,1327284,300,1032,0.5,"/Volumes/Drive/Thesis/new_data/sub20/log_files/sub20_S2_ASTrain.xls"
"1193","78","69",-0.5,78,31,45,2,776,1579048,1580545,1581942,1586533,1587309,1327284,-100,776,-0.5,"/Volumes/Drive/Thesis/new_data/sub20/log_files/sub20_S2_ASTrain.xls"
"1194","79","52",0.5,46,27,63,1,1196,1597943,1599440,1600838,1605628,1606824,1327284,100,1196,0.5,"/Volumes/Drive/Thesis/new_data/sub20/log_files/sub20_S2_ASTrain.xls"
"1195","80","62",0.5,59,13,74,1,443,1617754,1619251,1620648,1625755,1626198,1327284,400,443,0.5,"/Volumes/Drive/Thesis/new_data/sub20/log_files/sub20_S2_ASTrain.xls"
"1196","81","19",0.5,34,23,67,2,713,1637065,1638562,1639960,1644750,1645463,1327284,100,713,0.5,"/Volumes/Drive/Thesis/new_data/sub20/log_files/sub20_S2_ASTrain.xls"
"1197","82","77",-0.5,86,25,71,2,1097,1656360,1657857,1659254,1663646,1664743,1327284,-300,1097,-0.5,"/Volumes/Drive/Thesis/new_data/sub20/log_files/sub20_S2_ASTrain.xls"
"1198","83","82",-0.5,48,14,32,1,764,1675672,1677169,1678566,1683057,1683821,1327284,-200,764,0.5,"/Volumes/Drive/Thesis/new_data/sub20/log_files/sub20_S2_ASTrain.xls"
"1199","84","24",0.5,61,23,82,1,994,1694684,1696181,1697578,1702169,1703163,1327284,-100,994,0.5,"/Volumes/Drive/Thesis/new_data/sub20/log_files/sub20_S2_ASTrain.xls"
"1200","85","1",0.5,51,23,64,2,745,1713995,1715492,1716889,1721996,1722741,1327284,400,745,-0.5,"/Volumes/Drive/Thesis/new_data/sub20/log_files/sub20_S2_ASTrain.xls"
"1201","86","122",-0.5,52,14,36,1,1215,1734005,1735502,1736900,1741790,1743005,1327284,200,1215,0.5,"/Volumes/Drive/Thesis/new_data/sub20/log_files/sub20_S2_ASTrain.xls"
"1202","87","85",-0.5,65,24,43,2,1092,1753117,1754614,1756011,1760303,1761395,1327284,-400,1092,0.5,"/Volumes/Drive/Thesis/new_data/sub20/log_files/sub20_S2_ASTrain.xls"
"1203","88","37",0.5,46,28,64,1,1093,1772412,1773909,1775306,1779598,1780691,1327284,-400,1093,-0.5,"/Volumes/Drive/Thesis/new_data/sub20/log_files/sub20_S2_ASTrain.xls"
"1204","89","54",0.5,47,35,80,1,553,1790908,1792405,1793803,1798809,1799362,1327284,300,553,0.5,"/Volumes/Drive/Thesis/new_data/sub20/log_files/sub20_S2_ASTrain.xls"
"1205","90","53",0.5,57,16,75,2,485,1810935,1812432,1813829,1818720,1819205,1327284,200,485,0.5,"/Volumes/Drive/Thesis/new_data/sub20/log_files/sub20_S2_ASTrain.xls"
"1206","91","112",-0.5,57,18,49,1,475,1830247,1831744,1833141,1837432,1837907,1327284,-400,475,-0.5,"/Volumes/Drive/Thesis/new_data/sub20/log_files/sub20_S2_ASTrain.xls"
"1207","92","86",-0.5,75,13,64,1,654,1849442,1850938,1852336,1856627,1857281,1327284,-400,654,0.5,"/Volumes/Drive/Thesis/new_data/sub20/log_files/sub20_S2_ASTrain.xls"
"1208","93","30",0.5,46,32,68,1,1377,1868753,1870250,1871647,1876138,1877515,1327284,-200,1377,0.5,"/Volumes/Drive/Thesis/new_data/sub20/log_files/sub20_S2_ASTrain.xls"
"1209","94","16",0.5,45,34,89,1,456,1887948,1889445,1890842,1895833,1896289,1327284,300,456,-0.5,"/Volumes/Drive/Thesis/new_data/sub20/log_files/sub20_S2_ASTrain.xls"
"1210","95","70",-0.5,68,23,35,1,579,1907360,1908856,1910254,1914778,1915357,1327284,-200,579,-0.5,"/Volumes/Drive/Thesis/new_data/sub20/log_files/sub20_S2_ASTrain.xls"
"1211","96","41",0.5,54,17,81,2,1529,1926089,1927586,1928983,1933374,1934903,1327284,-300,1529,-0.5,"/Volumes/Drive/Thesis/new_data/sub20/log_files/sub20_S2_ASTrain.xls"
"1212","98","42",0.5,52,19,61,2,1030,1996266,1997763,1999160,2003651,2004681,1977340,-200,1030,-0.5,"/Volumes/Drive/Thesis/new_data/sub20/log_files/sub20_S2_ASTrain.xls"
"1213","99","33",0.5,58,16,72,2,485,2014978,2016475,2017872,2022164,2022649,1977340,-400,485,-0.5,"/Volumes/Drive/Thesis/new_data/sub20/log_files/sub20_S2_ASTrain.xls"
"1214","100","90",-0.5,74,43,41,1,838,2033791,2035288,2036685,2041076,2041914,1977340,-300,838,0.5,"/Volumes/Drive/Thesis/new_data/sub20/log_files/sub20_S2_ASTrain.xls"
"1215","101","27",0.5,41,17,56,2,1603,2053002,2054499,2055897,2060388,2061991,1977340,-200,1603,0.5,"/Volumes/Drive/Thesis/new_data/sub20/log_files/sub20_S2_ASTrain.xls"
"1216","102","2",0.5,41,23,74,1,740,2072214,2073711,2075125,2079516,2080256,1977340,-300,740,-0.5,"/Volumes/Drive/Thesis/new_data/sub20/log_files/sub20_S2_ASTrain.xls"
"1217","103","110",-0.5,86,18,58,2,993,2091343,2092840,2094237,2099027,2100020,1977340,100,993,-0.5,"/Volumes/Drive/Thesis/new_data/sub20/log_files/sub20_S2_ASTrain.xls"
"1218","105","36",0.5,57,18,65,2,1315,2130531,2132028,2133425,2138532,2139847,1977340,400,1315,-0.5,"/Volumes/Drive/Thesis/new_data/sub20/log_files/sub20_S2_ASTrain.xls"
"1219","106","100",-0.5,74,35,49,1,862,2150658,2152155,2153552,2157843,2158705,1977340,-400,862,-0.5,"/Volumes/Drive/Thesis/new_data/sub20/log_files/sub20_S2_ASTrain.xls"
"1220","107","68",-0.5,46,14,34,1,1441,2169753,2171250,2172647,2177654,2179095,1977340,300,1441,-0.5,"/Volumes/Drive/Thesis/new_data/sub20/log_files/sub20_S2_ASTrain.xls"
"1221","108","18",0.5,32,13,47,2,1126,2189264,2190761,2192158,2197265,2198391,1977340,400,1126,0.5,"/Volumes/Drive/Thesis/new_data/sub20/log_files/sub20_S2_ASTrain.xls"
"1222","111","87",-0.5,86,24,52,1,964,2247365,2248862,2250259,2255049,2256013,1977340,100,964,0.5,"/Volumes/Drive/Thesis/new_data/sub20/log_files/sub20_S2_ASTrain.xls"
"1223","112","40",0.5,67,15,84,2,1683,2266976,2268473,2269870,2274361,2276044,1977340,-200,1683,-0.5,"/Volumes/Drive/Thesis/new_data/sub20/log_files/sub20_S2_ASTrain.xls"
"1224","113","58",0.5,54,18,74,1,552,2285988,2287485,2288882,2293772,2294324,1977340,200,552,0.5,"/Volumes/Drive/Thesis/new_data/sub20/log_files/sub20_S2_ASTrain.xls"
"1225","114","73",-0.5,83,51,34,2,558,2305798,2307295,2308692,2312984,2313542,1977340,-400,558,-0.5,"/Volumes/Drive/Thesis/new_data/sub20/log_files/sub20_S2_ASTrain.xls"
"1226","115","93",-0.5,68,37,21,2,500,2324794,2326291,2327688,2332478,2332978,1977340,100,500,0.5,"/Volumes/Drive/Thesis/new_data/sub20/log_files/sub20_S2_ASTrain.xls"
"1227","116","17",0.5,62,14,78,2,578,2343806,2345303,2346700,2351806,2352384,1977340,400,578,0.5,"/Volumes/Drive/Thesis/new_data/sub20/log_files/sub20_S2_ASTrain.xls"
"1228","117","61",0.5,39,24,61,2,782,2363317,2364814,2366211,2371101,2371883,1977340,200,782,0.5,"/Volumes/Drive/Thesis/new_data/sub20/log_files/sub20_S2_ASTrain.xls"
"1229","118","59",0.5,43,28,81,1,1389,2383227,2384724,2386121,2390712,2392101,1977340,-100,1389,0.5,"/Volumes/Drive/Thesis/new_data/sub20/log_files/sub20_S2_ASTrain.xls"
"1230","119","13",0.5,58,21,69,2,763,2402023,2403520,2404917,2410024,2410787,1977340,400,763,-0.5,"/Volumes/Drive/Thesis/new_data/sub20/log_files/sub20_S2_ASTrain.xls"
"1231","122","106",-0.5,52,13,37,1,479,2460240,2461737,2463134,2468025,2468504,1977340,200,479,-0.5,"/Volumes/Drive/Thesis/new_data/sub20/log_files/sub20_S2_ASTrain.xls"
"1232","123","63",0.5,47,24,61,2,499,2480034,2481531,2482928,2487519,2488018,1977340,-100,499,0.5,"/Volumes/Drive/Thesis/new_data/sub20/log_files/sub20_S2_ASTrain.xls"
"1233","124","127",-0.5,65,27,48,2,1083,2498846,2500343,2501741,2506747,2507830,1977340,300,1083,0.5,"/Volumes/Drive/Thesis/new_data/sub20/log_files/sub20_S2_ASTrain.xls"
"1234","125","104",-0.5,51,16,25,1,627,2518673,2520171,2521568,2526358,2526985,1977340,100,627,-0.5,"/Volumes/Drive/Thesis/new_data/sub20/log_files/sub20_S2_ASTrain.xls"
"1235","126","94",-0.5,86,35,61,1,643,2537869,2539366,2540763,2545154,2545797,1977340,-300,643,0.5,"/Volumes/Drive/Thesis/new_data/sub20/log_files/sub20_S2_ASTrain.xls"
"1236","127","75",-0.5,84,52,42,1,815,2556664,2558161,2559559,2563950,2564765,1977340,-300,815,-0.5,"/Volumes/Drive/Thesis/new_data/sub20/log_files/sub20_S2_ASTrain.xls"
"1237","128","74",-0.5,63,12,41,1,430,2575377,2576874,2578271,2583162,2583592,1977340,200,430,-0.5,"/Volumes/Drive/Thesis/new_data/sub20/log_files/sub20_S2_ASTrain.xls"
"1238","1","65",-0.5,68,12,54,2,654,14552,16049,17446,21937,22591,14369,-200,654,-0.5,"/Volumes/Drive/Thesis/new_data/sub21/log_files/sub21_S2_ASTrain.xls"
"1239","2","125",-0.5,75,38,39,2,1067,33365,34862,36259,40850,41917,14369,-100,1067,0.5,"/Volumes/Drive/Thesis/new_data/sub21/log_files/sub21_S2_ASTrain.xls"
"1240","3","80",-0.5,59,18,31,1,1421,52377,53874,55272,60262,61683,14369,300,1421,-0.5,"/Volumes/Drive/Thesis/new_data/sub21/log_files/sub21_S2_ASTrain.xls"
"1241","4","2",0.5,41,23,74,1,1001,72388,73885,75282,80072,81073,14369,100,1001,-0.5,"/Volumes/Drive/Thesis/new_data/sub21/log_files/sub21_S2_ASTrain.xls"
"1242","5","66",-0.5,86,41,43,1,566,91699,93197,94594,99085,99651,14369,-200,566,-0.5,"/Volumes/Drive/Thesis/new_data/sub21/log_files/sub21_S2_ASTrain.xls"
"1243","6","21",0.5,41,34,73,2,1346,110412,111910,113357,117648,118994,14369,-400,1346,0.5,"/Volumes/Drive/Thesis/new_data/sub21/log_files/sub21_S2_ASTrain.xls"
"1244","7","118",-0.5,73,27,48,1,703,129774,131271,132668,137775,138478,14369,400,703,0.5,"/Volumes/Drive/Thesis/new_data/sub21/log_files/sub21_S2_ASTrain.xls"
"1245","8","113",-0.5,82,19,65,2,612,149302,150799,152196,156787,157399,14369,-100,612,0.5,"/Volumes/Drive/Thesis/new_data/sub21/log_files/sub21_S2_ASTrain.xls"
"1246","9","52",0.5,46,27,63,1,740,168098,169595,170993,175284,176024,14369,-400,740,0.5,"/Volumes/Drive/Thesis/new_data/sub21/log_files/sub21_S2_ASTrain.xls"
"1247","10","95",-0.5,68,15,51,2,612,187211,188708,190105,194396,195008,14369,-400,612,0.5,"/Volumes/Drive/Thesis/new_data/sub21/log_files/sub21_S2_ASTrain.xls"
"1248","11","24",0.5,61,23,82,1,538,206406,207903,209300,214407,214945,14369,400,538,0.5,"/Volumes/Drive/Thesis/new_data/sub21/log_files/sub21_S2_ASTrain.xls"
"1249","12","88",-0.5,45,14,41,1,488,225834,227331,228728,233519,234007,14369,100,488,0.5,"/Volumes/Drive/Thesis/new_data/sub21/log_files/sub21_S2_ASTrain.xls"
"1250","13","5",0.5,43,14,67,2,749,244946,246443,247841,252132,252881,14369,-400,749,-0.5,"/Volumes/Drive/Thesis/new_data/sub21/log_files/sub21_S2_ASTrain.xls"
"1251","14","82",-0.5,48,14,32,1,440,263959,265456,266853,271644,272084,14369,100,440,0.5,"/Volumes/Drive/Thesis/new_data/sub21/log_files/sub21_S2_ASTrain.xls"
"1252","15","79",-0.5,49,17,34,2,528,283271,284768,286165,291055,291583,14369,200,528,-0.5,"/Volumes/Drive/Thesis/new_data/sub21/log_files/sub21_S2_ASTrain.xls"
"1253","16","10",0.5,42,37,69,1,413,302466,303963,305360,309951,310364,14369,-100,413,-0.5,"/Volumes/Drive/Thesis/new_data/sub21/log_files/sub21_S2_ASTrain.xls"
"1254","17","28",0.5,52,16,78,1,594,321562,323059,324456,328847,329441,14369,-300,594,0.5,"/Volumes/Drive/Thesis/new_data/sub21/log_files/sub21_S2_ASTrain.xls"
"1255","18","44",0.5,43,29,74,1,513,340657,342154,343585,348475,348988,14369,200,513,-0.5,"/Volumes/Drive/Thesis/new_data/sub21/log_files/sub21_S2_ASTrain.xls"
"1256","19","61",0.5,39,24,61,2,724,360385,361882,363279,368169,368893,14369,200,724,0.5,"/Volumes/Drive/Thesis/new_data/sub21/log_files/sub21_S2_ASTrain.xls"
"1257","20","104",-0.5,51,16,25,1,800,379979,381476,382874,387265,388065,14369,-300,800,-0.5,"/Volumes/Drive/Thesis/new_data/sub21/log_files/sub21_S2_ASTrain.xls"
"1258","21","25",0.5,61,18,69,2,762,398792,400289,401686,406677,407439,14369,300,762,0.5,"/Volumes/Drive/Thesis/new_data/sub21/log_files/sub21_S2_ASTrain.xls"
"1259","22","115",-0.5,64,25,29,2,885,417988,419485,420882,425772,426657,14369,200,885,0.5,"/Volumes/Drive/Thesis/new_data/sub21/log_files/sub21_S2_ASTrain.xls"
"1260","23","110",-0.5,86,18,58,1,593,437898,439395,440792,445783,446376,14369,300,593,-0.5,"/Volumes/Drive/Thesis/new_data/sub21/log_files/sub21_S2_ASTrain.xls"
"1261","24","56",0.5,58,17,65,1,750,457792,459289,460686,465078,465828,14369,-300,750,0.5,"/Volumes/Drive/Thesis/new_data/sub21/log_files/sub21_S2_ASTrain.xls"
"1262","25","39",0.5,48,27,73,2,723,477104,478601,479998,485105,485828,14369,400,723,-0.5,"/Volumes/Drive/Thesis/new_data/sub21/log_files/sub21_S2_ASTrain.xls"
"1263","26","40",0.5,67,15,84,1,657,497031,498528,499925,504467,505124,14369,-200,657,-0.5,"/Volumes/Drive/Thesis/new_data/sub21/log_files/sub21_S2_ASTrain.xls"
"1264","27","86",-0.5,75,13,64,1,539,516493,517990,519387,524178,524717,14369,100,539,0.5,"/Volumes/Drive/Thesis/new_data/sub21/log_files/sub21_S2_ASTrain.xls"
"1265","28","14",0.5,48,21,71,1,524,536004,537501,538898,544005,544529,14369,400,524,-0.5,"/Volumes/Drive/Thesis/new_data/sub21/log_files/sub21_S2_ASTrain.xls"
"1266","29","100",-0.5,74,35,49,1,715,555516,557013,558410,563001,563716,14369,-100,715,-0.5,"/Volumes/Drive/Thesis/new_data/sub21/log_files/sub21_S2_ASTrain.xls"
"1267","30","38",0.5,39,25,74,2,965,574328,575825,577223,581614,582579,14369,-300,965,-0.5,"/Volumes/Drive/Thesis/new_data/sub21/log_files/sub21_S2_ASTrain.xls"
"1268","31","101",-0.5,64,18,48,1,700,593740,595237,596634,601624,602324,14369,300,700,-0.5,"/Volumes/Drive/Thesis/new_data/sub21/log_files/sub21_S2_ASTrain.xls"
"1269","32","49",0.5,39,17,58,2,703,613251,614748,616146,620636,621339,14369,-200,703,0.5,"/Volumes/Drive/Thesis/new_data/sub21/log_files/sub21_S2_ASTrain.xls"
"1270","33","20",0.5,51,24,65,1,529,678422,679920,681317,685808,686337,678405,-200,529,0.5,"/Volumes/Drive/Thesis/new_data/sub21/log_files/sub21_S2_ASTrain.xls"
"1271","34","72",-0.5,79,21,68,1,451,697618,699115,700512,705402,705853,678405,200,451,-0.5,"/Volumes/Drive/Thesis/new_data/sub21/log_files/sub21_S2_ASTrain.xls"
"1272","35","126",-0.5,87,38,47,1,616,717429,718926,720323,724814,725430,678405,-200,616,0.5,"/Volumes/Drive/Thesis/new_data/sub21/log_files/sub21_S2_ASTrain.xls"
"1273","36","109",-0.5,75,26,47,2,905,736641,738138,739535,744525,745430,678405,300,905,-0.5,"/Volumes/Drive/Thesis/new_data/sub21/log_files/sub21_S2_ASTrain.xls"
"1274","37","60",0.5,34,29,53,1,767,756152,757649,759046,764053,764820,678405,300,767,0.5,"/Volumes/Drive/Thesis/new_data/sub21/log_files/sub21_S2_ASTrain.xls"
"1275","38","58",0.5,54,18,74,1,670,776179,777676,779073,784180,784850,678405,400,670,0.5,"/Volumes/Drive/Thesis/new_data/sub21/log_files/sub21_S2_ASTrain.xls"
"1276","39","41",0.5,54,17,81,2,636,795607,797104,798502,803292,803928,678405,100,636,-0.5,"/Volumes/Drive/Thesis/new_data/sub21/log_files/sub21_S2_ASTrain.xls"
"1277","40","94",-0.5,86,35,61,1,486,814720,816217,817614,822504,822990,678405,200,486,0.5,"/Volumes/Drive/Thesis/new_data/sub21/log_files/sub21_S2_ASTrain.xls"
"1278","41","63",0.5,47,24,61,2,689,834527,836027,837425,841816,842505,678405,-300,689,0.5,"/Volumes/Drive/Thesis/new_data/sub21/log_files/sub21_S2_ASTrain.xls"
"1279","42","27",0.5,41,17,56,2,758,853343,854840,856238,861028,861786,678405,100,758,0.5,"/Volumes/Drive/Thesis/new_data/sub21/log_files/sub21_S2_ASTrain.xls"
"1280","43","108",-0.5,72,23,39,1,1207,872938,874435,875832,880656,881863,678405,100,1207,-0.5,"/Volumes/Drive/Thesis/new_data/sub21/log_files/sub21_S2_ASTrain.xls"
"1281","44","119",-0.5,54,17,27,1,1452,892566,894063,895460,900051,901503,678405,-100,1452,0.5,"/Volumes/Drive/Thesis/new_data/sub21/log_files/sub21_S2_ASTrain.xls"
"1282","45","46",0.5,29,14,41,1,498,911378,912875,914273,918864,919362,678405,-100,498,-0.5,"/Volumes/Drive/Thesis/new_data/sub21/log_files/sub21_S2_ASTrain.xls"
"1283","46","43",0.5,43,19,64,2,1057,930790,932287,933684,937976,939033,678405,-400,1057,-0.5,"/Volumes/Drive/Thesis/new_data/sub21/log_files/sub21_S2_ASTrain.xls"
"1284","47","16",0.5,45,34,89,1,900,950085,951582,952980,958086,958986,678405,400,900,-0.5,"/Volumes/Drive/Thesis/new_data/sub21/log_files/sub21_S2_ASTrain.xls"
"1285","48","84",-0.5,89,41,46,2,1196,969414,970911,972308,976899,978095,678405,-100,1196,0.5,"/Volumes/Drive/Thesis/new_data/sub21/log_files/sub21_S2_ASTrain.xls"
"1286","50","42",0.5,52,19,61,1,966,1007206,1008703,1010100,1015206,1016172,678405,400,966,-0.5,"/Volumes/Drive/Thesis/new_data/sub21/log_files/sub21_S2_ASTrain.xls"
"1287","51","3",0.5,52,24,74,2,717,1027233,1028730,1030127,1035017,1035734,678405,200,717,-0.5,"/Volumes/Drive/Thesis/new_data/sub21/log_files/sub21_S2_ASTrain.xls"
"1288","52","87",-0.5,86,24,52,2,956,1046345,1047842,1049239,1053730,1054686,678405,-200,956,0.5,"/Volumes/Drive/Thesis/new_data/sub21/log_files/sub21_S2_ASTrain.xls"
"1289","53","8",0.5,24,13,47,1,460,1065041,1066538,1067936,1072726,1073186,678405,100,460,-0.5,"/Volumes/Drive/Thesis/new_data/sub21/log_files/sub21_S2_ASTrain.xls"
"1290","54","99",-0.5,83,25,48,2,1016,1084137,1085634,1087031,1092138,1093154,678405,400,1016,-0.5,"/Volumes/Drive/Thesis/new_data/sub21/log_files/sub21_S2_ASTrain.xls"
"1291","55","114",-0.5,82,28,52,1,1101,1103964,1105461,1106859,1111849,1112950,678405,300,1101,0.5,"/Volumes/Drive/Thesis/new_data/sub21/log_files/sub21_S2_ASTrain.xls"
"1292","56","91",-0.5,74,42,42,2,586,1123376,1124873,1126270,1130661,1131247,678405,-300,586,0.5,"/Volumes/Drive/Thesis/new_data/sub21/log_files/sub21_S2_ASTrain.xls"
"1293","57","4",0.5,53,21,76,1,429,1142588,1144085,1145482,1149973,1150402,678405,-200,429,-0.5,"/Volumes/Drive/Thesis/new_data/sub21/log_files/sub21_S2_ASTrain.xls"
"1294","58","124",-0.5,72,24,38,1,439,1161584,1163081,1164478,1168869,1169308,678405,-300,439,0.5,"/Volumes/Drive/Thesis/new_data/sub21/log_files/sub21_S2_ASTrain.xls"
"1295","59","78",-0.5,79,36,53,1,470,1180696,1182193,1183590,1188181,1188651,678405,-100,470,-0.5,"/Volumes/Drive/Thesis/new_data/sub21/log_files/sub21_S2_ASTrain.xls"
"1296","60","76",-0.5,53,21,34,1,476,1199708,1201205,1202603,1206894,1207370,678405,-400,476,-0.5,"/Volumes/Drive/Thesis/new_data/sub21/log_files/sub21_S2_ASTrain.xls"
"1297","61","68",-0.5,46,14,34,1,652,1218504,1220001,1221399,1226389,1227041,678405,300,652,-0.5,"/Volumes/Drive/Thesis/new_data/sub21/log_files/sub21_S2_ASTrain.xls"
"1298","62","18",0.5,32,13,47,1,605,1238515,1240012,1241409,1245701,1246306,678405,-400,605,0.5,"/Volumes/Drive/Thesis/new_data/sub21/log_files/sub21_S2_ASTrain.xls"
"1299","63","30",0.5,46,32,68,1,663,1257827,1259324,1260721,1265611,1266274,678405,200,663,0.5,"/Volumes/Drive/Thesis/new_data/sub21/log_files/sub21_S2_ASTrain.xls"
"1300","64","53",0.5,57,16,75,2,684,1277022,1278519,1279916,1284308,1284992,678405,-300,684,0.5,"/Volumes/Drive/Thesis/new_data/sub21/log_files/sub21_S2_ASTrain.xls"
"1301","66","36",0.5,57,18,65,2,1111,1354053,1355550,1356947,1361738,1362849,1334589,100,1111,-0.5,"/Volumes/Drive/Thesis/new_data/sub21/log_files/sub21_S2_ASTrain.xls"
"1302","67","106",-0.5,52,13,37,1,528,1373348,1374845,1376242,1381133,1381661,1334589,200,528,-0.5,"/Volumes/Drive/Thesis/new_data/sub21/log_files/sub21_S2_ASTrain.xls"
"1303","68","103",-0.5,73,15,68,2,1002,1392444,1393941,1395338,1399862,1400864,1334589,-200,1002,-0.5,"/Volumes/Drive/Thesis/new_data/sub21/log_files/sub21_S2_ASTrain.xls"
"1304","69","31",0.5,67,12,69,2,1136,1411390,1412887,1414284,1419274,1420410,1334589,300,1136,0.5,"/Volumes/Drive/Thesis/new_data/sub21/log_files/sub21_S2_ASTrain.xls"
"1305","70","96",-0.5,56,15,31,1,702,1431101,1432598,1433995,1438286,1438988,1334589,-400,702,0.5,"/Volumes/Drive/Thesis/new_data/sub21/log_files/sub21_S2_ASTrain.xls"
"1306","71","121",-0.5,61,24,39,2,656,1450412,1451909,1453307,1458097,1458753,1334589,100,656,0.5,"/Volumes/Drive/Thesis/new_data/sub21/log_files/sub21_S2_ASTrain.xls"
"1307","72","15",0.5,47,31,76,2,752,1469408,1470905,1472303,1476594,1477346,1334589,-400,752,-0.5,"/Volumes/Drive/Thesis/new_data/sub21/log_files/sub21_S2_ASTrain.xls"
"1308","73","59",0.5,43,28,81,2,553,1488620,1490117,1491515,1496105,1496658,1334589,-100,553,0.5,"/Volumes/Drive/Thesis/new_data/sub21/log_files/sub21_S2_ASTrain.xls"
"1309","74","47",0.5,49,23,62,1,1501,1507433,1508930,1510327,1514719,1516220,1334589,-300,1501,-0.5,"/Volumes/Drive/Thesis/new_data/sub21/log_files/sub21_S2_ASTrain.xls"
"1310","75","13",0.5,58,21,69,2,742,1526246,1527743,1529140,1533931,1534673,1334589,100,742,-0.5,"/Volumes/Drive/Thesis/new_data/sub21/log_files/sub21_S2_ASTrain.xls"
"1311","76","122",-0.5,52,14,36,1,738,1545940,1547437,1548835,1553825,1554563,1334589,300,738,0.5,"/Volumes/Drive/Thesis/new_data/sub21/log_files/sub21_S2_ASTrain.xls"
"1312","77","83",-0.5,48,23,23,2,673,1565951,1567448,1568845,1573952,1574625,1334589,400,673,0.5,"/Volumes/Drive/Thesis/new_data/sub21/log_files/sub21_S2_ASTrain.xls"
"1313","78","9",0.5,24,15,37,2,665,1585362,1586859,1588257,1593147,1593812,1334589,200,665,-0.5,"/Volumes/Drive/Thesis/new_data/sub21/log_files/sub21_S2_ASTrain.xls"
"1314","79","92",-0.5,83,21,64,1,534,1604674,1606171,1607568,1612558,1613092,1334589,300,534,0.5,"/Volumes/Drive/Thesis/new_data/sub21/log_files/sub21_S2_ASTrain.xls"
"1315","80","75",-0.5,84,52,42,2,659,1624485,1625982,1627379,1631870,1632529,1334589,-200,659,-0.5,"/Volumes/Drive/Thesis/new_data/sub21/log_files/sub21_S2_ASTrain.xls"
"1316","81","70",-0.5,68,23,35,1,449,1643680,1645177,1646575,1651165,1651614,1334589,-100,449,-0.5,"/Volumes/Drive/Thesis/new_data/sub21/log_files/sub21_S2_ASTrain.xls"
"1317","82","57",0.5,54,19,71,2,635,1662591,1664090,1665487,1669878,1670513,1334589,-300,635,0.5,"/Volumes/Drive/Thesis/new_data/sub21/log_files/sub21_S2_ASTrain.xls"
"1318","83","116",-0.5,53,17,46,2,1416,1681805,1683302,1684699,1689190,1690606,1334589,-200,1416,0.5,"/Volumes/Drive/Thesis/new_data/sub21/log_files/sub21_S2_ASTrain.xls"
"1319","84","22",0.5,31,23,56,1,875,1701117,1702614,1704011,1708402,1709277,1334589,-300,875,0.5,"/Volumes/Drive/Thesis/new_data/sub21/log_files/sub21_S2_ASTrain.xls"
"1320","85","54",0.5,47,35,80,1,579,1720212,1721709,1723107,1728213,1728792,1334589,400,579,0.5,"/Volumes/Drive/Thesis/new_data/sub21/log_files/sub21_S2_ASTrain.xls"
"1321","86","112",-0.5,57,18,49,1,1142,1739524,1741021,1742418,1747009,1748151,1334589,-100,1142,-0.5,"/Volumes/Drive/Thesis/new_data/sub21/log_files/sub21_S2_ASTrain.xls"
"1322","87","23",0.5,64,12,78,2,1209,1758819,1760316,1761714,1766504,1767713,1334589,100,1209,0.5,"/Volumes/Drive/Thesis/new_data/sub21/log_files/sub21_S2_ASTrain.xls"
"1323","89","45",0.5,48,24,82,2,545,1797210,1798707,1800104,1805011,1805556,1334589,200,545,-0.5,"/Volumes/Drive/Thesis/new_data/sub21/log_files/sub21_S2_ASTrain.xls"
"1324","90","26",0.5,31,28,69,1,603,1817021,1818518,1819915,1824905,1825508,1334589,300,603,0.5,"/Volumes/Drive/Thesis/new_data/sub21/log_files/sub21_S2_ASTrain.xls"
"1325","91","74",-0.5,63,12,41,1,637,1836532,1838029,1839427,1843918,1844555,1334589,-200,637,-0.5,"/Volumes/Drive/Thesis/new_data/sub21/log_files/sub21_S2_ASTrain.xls"
"1326","92","48",0.5,49,24,71,1,665,1855844,1857341,1858738,1863030,1863695,1334589,-400,665,-0.5,"/Volumes/Drive/Thesis/new_data/sub21/log_files/sub21_S2_ASTrain.xls"
"1327","93","123",-0.5,62,13,59,1,421,1875056,1876553,1877950,1882242,1882663,1334589,-400,421,0.5,"/Volumes/Drive/Thesis/new_data/sub21/log_files/sub21_S2_ASTrain.xls"
"1328","94","67",-0.5,47,13,24,2,887,1894368,1895865,1897262,1902369,1903256,1334589,400,887,-0.5,"/Volumes/Drive/Thesis/new_data/sub21/log_files/sub21_S2_ASTrain.xls"
"1329","95","85",-0.5,65,24,43,2,558,1913896,1915393,1916790,1921182,1921740,1334589,-300,558,0.5,"/Volumes/Drive/Thesis/new_data/sub21/log_files/sub21_S2_ASTrain.xls"
"1330","96","7",0.5,42,34,78,2,612,1932592,1934089,1935487,1940377,1940989,1334589,200,612,-0.5,"/Volumes/Drive/Thesis/new_data/sub21/log_files/sub21_S2_ASTrain.xls"
"1331","97","17",0.5,62,14,78,2,611,2114832,2116329,2117726,2122217,2122828,2114767,-200,611,0.5,"/Volumes/Drive/Thesis/new_data/sub21/log_files/sub21_S2_ASTrain.xls"
"1332","98","71",-0.5,67,14,51,2,663,2134327,2135824,2137221,2142211,2142874,2114767,300,663,-0.5,"/Volumes/Drive/Thesis/new_data/sub21/log_files/sub21_S2_ASTrain.xls"
"1333","99","1",0.5,51,23,64,2,1321,2154121,2155618,2157015,2161506,2162827,2114767,-200,1321,-0.5,"/Volumes/Drive/Thesis/new_data/sub21/log_files/sub21_S2_ASTrain.xls"
"1334","100","62",0.5,59,13,74,1,683,2173333,2174830,2176227,2181018,2181701,2114767,100,683,0.5,"/Volumes/Drive/Thesis/new_data/sub21/log_files/sub21_S2_ASTrain.xls"
"1335","101","77",-0.5,86,25,71,2,586,2192645,2194142,2195539,2200130,2200716,2114767,-100,586,-0.5,"/Volumes/Drive/Thesis/new_data/sub21/log_files/sub21_S2_ASTrain.xls"
"1336","103","89",-0.5,54,12,32,2,445,2231351,2232848,2234246,2239036,2239481,2114767,100,445,0.5,"/Volumes/Drive/Thesis/new_data/sub21/log_files/sub21_S2_ASTrain.xls"
"1337","104","33",0.5,58,16,72,2,586,2250447,2251944,2253341,2258248,2258834,2114767,200,586,-0.5,"/Volumes/Drive/Thesis/new_data/sub21/log_files/sub21_S2_ASTrain.xls"
"1338","105","64",0.5,38,14,62,1,1394,2269676,2271173,2272570,2276961,2278355,2114767,-300,1394,0.5,"/Volumes/Drive/Thesis/new_data/sub21/log_files/sub21_S2_ASTrain.xls"
"1339","106","127",-0.5,65,27,48,2,995,2288771,2290268,2291666,2296656,2297651,2114767,300,995,0.5,"/Volumes/Drive/Thesis/new_data/sub21/log_files/sub21_S2_ASTrain.xls"
"1340","107","97",-0.5,51,19,34,2,651,2308565,2310062,2311460,2316250,2316901,2114767,100,651,-0.5,"/Volumes/Drive/Thesis/new_data/sub21/log_files/sub21_S2_ASTrain.xls"
"1341","108","81",-0.5,76,24,54,2,494,2328077,2329574,2330971,2336078,2336572,2114767,400,494,0.5,"/Volumes/Drive/Thesis/new_data/sub21/log_files/sub21_S2_ASTrain.xls"
"1342","109","111",-0.5,65,29,38,2,963,2347588,2349085,2350478,2354874,2355837,2114767,-300,963,-0.5,"/Volumes/Drive/Thesis/new_data/sub21/log_files/sub21_S2_ASTrain.xls"
"1343","110","120",-0.5,71,35,46,2,1083,2366484,2367981,2369378,2374485,2375568,2114767,400,1083,0.5,"/Volumes/Drive/Thesis/new_data/sub21/log_files/sub21_S2_ASTrain.xls"
"1344","111","11",0.5,61,17,76,2,511,2386511,2388008,2389406,2394512,2395023,2114767,400,511,-0.5,"/Volumes/Drive/Thesis/new_data/sub21/log_files/sub21_S2_ASTrain.xls"
"1345","112","117",-0.5,72,29,41,2,846,2405823,2407320,2408717,2413708,2414554,2114767,300,846,0.5,"/Volumes/Drive/Thesis/new_data/sub21/log_files/sub21_S2_ASTrain.xls"
"1346","113","105",-0.5,71,24,49,2,632,2425218,2426715,2428112,2432703,2433335,2114767,-100,632,-0.5,"/Volumes/Drive/Thesis/new_data/sub21/log_files/sub21_S2_ASTrain.xls"
"1347","114","12",0.5,62,16,68,1,602,2444729,2446227,2447624,2452514,2453116,2114767,200,602,-0.5,"/Volumes/Drive/Thesis/new_data/sub21/log_files/sub21_S2_ASTrain.xls"
"1348","115","93",-0.5,68,37,21,2,567,2464441,2465938,2467335,2471626,2472193,2114767,-400,567,0.5,"/Volumes/Drive/Thesis/new_data/sub21/log_files/sub21_S2_ASTrain.xls"
"1349","116","19",0.5,34,23,67,2,560,2483054,2484551,2485948,2490539,2491099,2114767,-100,560,0.5,"/Volumes/Drive/Thesis/new_data/sub21/log_files/sub21_S2_ASTrain.xls"
"1350","117","90",-0.5,74,43,41,1,524,2502149,2503646,2505044,2509934,2510458,2114767,200,524,0.5,"/Volumes/Drive/Thesis/new_data/sub21/log_files/sub21_S2_ASTrain.xls"
"1351","118","29",0.5,45,14,57,2,501,2521844,2523341,2524738,2529628,2530129,2114767,200,501,0.5,"/Volumes/Drive/Thesis/new_data/sub21/log_files/sub21_S2_ASTrain.xls"
"1352","119","50",0.5,49,25,72,1,501,2541754,2543251,2544698,2549190,2549691,2114767,-200,501,0.5,"/Volumes/Drive/Thesis/new_data/sub21/log_files/sub21_S2_ASTrain.xls"
"1353","120","6",0.5,52,13,67,1,592,2560817,2562314,2563711,2568817,2569409,2114767,400,592,-0.5,"/Volumes/Drive/Thesis/new_data/sub21/log_files/sub21_S2_ASTrain.xls"
"1354","121","107",-0.5,81,13,78,2,1042,2580627,2582124,2583522,2587913,2588955,2114767,-300,1042,-0.5,"/Volumes/Drive/Thesis/new_data/sub21/log_files/sub21_S2_ASTrain.xls"
"1355","122","51",0.5,37,25,72,2,1012,2599324,2600821,2602218,2606709,2607721,2114767,-200,1012,0.5,"/Volumes/Drive/Thesis/new_data/sub21/log_files/sub21_S2_ASTrain.xls"
"1356","123","37",0.5,46,28,64,2,1049,2618719,2620216,2621613,2625905,2626954,2114767,-400,1049,-0.5,"/Volumes/Drive/Thesis/new_data/sub21/log_files/sub21_S2_ASTrain.xls"
"1357","124","128",-0.5,75,27,38,1,611,2638031,2639528,2640958,2645749,2646360,2114767,100,611,0.5,"/Volumes/Drive/Thesis/new_data/sub21/log_files/sub21_S2_ASTrain.xls"
"1358","125","34",0.5,37,28,67,1,642,2657858,2659355,2660752,2665343,2665985,2114767,-100,642,-0.5,"/Volumes/Drive/Thesis/new_data/sub21/log_files/sub21_S2_ASTrain.xls"
"1359","126","69",-0.5,78,31,45,2,566,2676654,2678151,2679548,2683840,2684406,2114767,-400,566,-0.5,"/Volumes/Drive/Thesis/new_data/sub21/log_files/sub21_S2_ASTrain.xls"
"1360","127","73",-0.5,83,51,34,2,499,2695168,2696665,2698062,2702453,2702952,2114767,-300,499,-0.5,"/Volumes/Drive/Thesis/new_data/sub21/log_files/sub21_S2_ASTrain.xls"
"1361","128","32",0.5,47,21,78,1,551,2713980,2715477,2716875,2721166,2721717,2114767,-400,551,0.5,"/Volumes/Drive/Thesis/new_data/sub21/log_files/sub21_S2_ASTrain.xls"
"1362","1","9",0.5,24,15,37,2,570,19342,20839,22237,27343,27913,18948,400,570,-0.5,"/Volumes/Drive/Thesis/new_data/sub23/log_files/sub23_S2_ASTrain.xls"
"1363","2","102",-0.5,84,35,47,1,663,38671,40168,41565,46671,47334,18948,400,663,-0.5,"/Volumes/Drive/Thesis/new_data/sub23/log_files/sub23_S2_ASTrain.xls"
"1364","3","46",0.5,29,14,41,1,961,58481,59978,61376,65966,66927,18948,-100,961,-0.5,"/Volumes/Drive/Thesis/new_data/sub23/log_files/sub23_S2_ASTrain.xls"
"1365","4","79",-0.5,49,17,34,2,556,78076,79573,80970,85261,85817,18948,-400,556,-0.5,"/Volumes/Drive/Thesis/new_data/sub23/log_files/sub23_S2_ASTrain.xls"
"1366","5","19",0.5,34,23,67,2,599,96589,98086,99483,103874,104473,18948,-300,599,0.5,"/Volumes/Drive/Thesis/new_data/sub23/log_files/sub23_S2_ASTrain.xls"
"1367","6","63",0.5,47,24,61,2,653,115701,117198,118595,123585,124238,18948,300,653,0.5,"/Volumes/Drive/Thesis/new_data/sub23/log_files/sub23_S2_ASTrain.xls"
"1368","7","64",0.5,38,14,62,1,509,135013,136510,137907,142697,143206,18948,100,509,0.5,"/Volumes/Drive/Thesis/new_data/sub23/log_files/sub23_S2_ASTrain.xls"
"1369","8","38",0.5,39,25,74,1,609,154208,155705,157102,161893,162502,18948,100,609,-0.5,"/Volumes/Drive/Thesis/new_data/sub23/log_files/sub23_S2_ASTrain.xls"
"1370","9","7",0.5,42,34,78,2,539,173802,175299,176696,181587,182126,18948,200,539,-0.5,"/Volumes/Drive/Thesis/new_data/sub23/log_files/sub23_S2_ASTrain.xls"
"1371","10","74",-0.5,63,12,41,1,485,193014,194511,195908,201015,201500,18948,400,485,-0.5,"/Volumes/Drive/Thesis/new_data/sub23/log_files/sub23_S2_ASTrain.xls"
"1372","11","128",-0.5,75,27,38,2,1502,212542,214039,215436,220326,221828,18948,200,1502,0.5,"/Volumes/Drive/Thesis/new_data/sub23/log_files/sub23_S2_ASTrain.xls"
"1373","12","81",-0.5,76,24,54,2,480,232452,233949,235347,239738,240218,18948,-300,480,0.5,"/Volumes/Drive/Thesis/new_data/sub23/log_files/sub23_S2_ASTrain.xls"
"1374","13","112",-0.5,57,18,49,1,628,251149,252646,254043,258933,259561,18948,200,628,-0.5,"/Volumes/Drive/Thesis/new_data/sub23/log_files/sub23_S2_ASTrain.xls"
"1375","14","43",0.5,43,19,64,2,666,270743,272240,273637,278128,278794,18948,-200,666,-0.5,"/Volumes/Drive/Thesis/new_data/sub23/log_files/sub23_S2_ASTrain.xls"
"1376","15","13",0.5,58,21,69,2,541,289755,291252,292649,297440,297981,18948,100,541,-0.5,"/Volumes/Drive/Thesis/new_data/sub23/log_files/sub23_S2_ASTrain.xls"
"1377","16","5",0.5,43,14,67,2,515,309566,311063,312460,316951,317466,18948,-200,515,-0.5,"/Volumes/Drive/Thesis/new_data/sub23/log_files/sub23_S2_ASTrain.xls"
"1378","17","120",-0.5,71,35,46,1,1082,328977,330474,331872,336163,337245,18948,-400,1082,0.5,"/Volumes/Drive/Thesis/new_data/sub23/log_files/sub23_S2_ASTrain.xls"
"1379","18","70",-0.5,68,23,35,1,526,347990,349487,350884,355375,355901,18948,-200,526,-0.5,"/Volumes/Drive/Thesis/new_data/sub23/log_files/sub23_S2_ASTrain.xls"
"1380","19","95",-0.5,68,15,51,2,542,366985,368482,369879,374171,374713,18948,-400,542,0.5,"/Volumes/Drive/Thesis/new_data/sub23/log_files/sub23_S2_ASTrain.xls"
"1381","20","100",-0.5,74,35,49,1,931,386280,387777,389174,393765,394696,18948,-100,931,-0.5,"/Volumes/Drive/Thesis/new_data/sub23/log_files/sub23_S2_ASTrain.xls"
"1382","21","106",-0.5,52,13,37,1,501,405692,407189,408586,413476,413977,18948,200,501,-0.5,"/Volumes/Drive/Thesis/new_data/sub23/log_files/sub23_S2_ASTrain.xls"
"1383","22","82",-0.5,48,14,32,1,629,425003,426500,427898,432488,433117,18948,-100,629,0.5,"/Volumes/Drive/Thesis/new_data/sub23/log_files/sub23_S2_ASTrain.xls"
"1384","23","76",-0.5,53,21,34,1,660,443799,445296,446693,451800,452460,18948,400,660,-0.5,"/Volumes/Drive/Thesis/new_data/sub23/log_files/sub23_S2_ASTrain.xls"
"1385","24","127",-0.5,65,27,48,1,834,463710,465207,466604,471594,472428,18948,300,834,0.5,"/Volumes/Drive/Thesis/new_data/sub23/log_files/sub23_S2_ASTrain.xls"
"1386","25","45",0.5,48,24,82,2,453,483620,485117,486514,491521,491974,18948,300,453,-0.5,"/Volumes/Drive/Thesis/new_data/sub23/log_files/sub23_S2_ASTrain.xls"
"1387","26","29",0.5,45,14,57,2,483,502849,504346,505743,510334,510817,18948,-100,483,0.5,"/Volumes/Drive/Thesis/new_data/sub23/log_files/sub23_S2_ASTrain.xls"
"1388","27","52",0.5,46,27,63,1,407,522360,523857,525254,530045,530452,18948,100,407,0.5,"/Volumes/Drive/Thesis/new_data/sub23/log_files/sub23_S2_ASTrain.xls"
"1389","28","31",0.5,67,12,69,1,630,541671,543169,544566,548857,549487,18948,-400,630,0.5,"/Volumes/Drive/Thesis/new_data/sub23/log_files/sub23_S2_ASTrain.xls"
"1390","29","56",0.5,58,17,65,1,1653,560767,562264,563661,568052,569705,18948,-300,1653,0.5,"/Volumes/Drive/Thesis/new_data/sub23/log_files/sub23_S2_ASTrain.xls"
"1391","30","22",0.5,31,23,56,1,567,579580,581077,582474,587481,588048,18948,300,567,0.5,"/Volumes/Drive/Thesis/new_data/sub23/log_files/sub23_S2_ASTrain.xls"
"1392","31","87",-0.5,86,24,52,2,553,599507,601004,602401,606792,607345,18948,-300,553,0.5,"/Volumes/Drive/Thesis/new_data/sub23/log_files/sub23_S2_ASTrain.xls"
"1393","32","116",-0.5,53,17,46,1,1056,618419,619916,621313,625804,626860,18948,-200,1056,0.5,"/Volumes/Drive/Thesis/new_data/sub23/log_files/sub23_S2_ASTrain.xls"
"1394","33","47",0.5,49,23,62,2,481,668154,669651,671048,675439,675920,668046,-300,481,-0.5,"/Volumes/Drive/Thesis/new_data/sub23/log_files/sub23_S2_ASTrain.xls"
"1395","34","27",0.5,41,17,56,2,581,686767,688264,689661,694651,695232,668046,300,581,0.5,"/Volumes/Drive/Thesis/new_data/sub23/log_files/sub23_S2_ASTrain.xls"
"1396","35","91",-0.5,74,42,42,2,594,706477,707974,709372,714262,714856,668046,200,594,0.5,"/Volumes/Drive/Thesis/new_data/sub23/log_files/sub23_S2_ASTrain.xls"
"1397","36","66",-0.5,86,41,43,1,776,725673,727170,728567,733673,734449,668046,400,776,-0.5,"/Volumes/Drive/Thesis/new_data/sub23/log_files/sub23_S2_ASTrain.xls"
"1398","37","50",0.5,49,25,72,1,611,745583,747080,748477,752869,753480,668046,-300,611,0.5,"/Volumes/Drive/Thesis/new_data/sub23/log_files/sub23_S2_ASTrain.xls"
"1399","38","84",-0.5,89,41,46,1,694,764679,766176,767573,772363,773057,668046,100,694,0.5,"/Volumes/Drive/Thesis/new_data/sub23/log_files/sub23_S2_ASTrain.xls"
"1400","39","18",0.5,32,13,47,1,891,783774,785271,786668,791259,792150,668046,-100,891,0.5,"/Volumes/Drive/Thesis/new_data/sub23/log_files/sub23_S2_ASTrain.xls"
"1401","40","77",-0.5,86,25,71,2,739,802770,804267,805697,809989,810728,668046,-400,739,-0.5,"/Volumes/Drive/Thesis/new_data/sub23/log_files/sub23_S2_ASTrain.xls"
"1402","41","24",0.5,61,23,82,1,668,821516,823013,824410,829200,829868,668046,100,668,0.5,"/Volumes/Drive/Thesis/new_data/sub23/log_files/sub23_S2_ASTrain.xls"
"1403","42","2",0.5,41,23,74,1,930,841027,842524,843921,848312,849242,668046,-300,930,-0.5,"/Volumes/Drive/Thesis/new_data/sub23/log_files/sub23_S2_ASTrain.xls"
"1404","43","1",0.5,51,23,64,2,534,860222,861719,863116,868223,868757,668046,400,534,-0.5,"/Volumes/Drive/Thesis/new_data/sub23/log_files/sub23_S2_ASTrain.xls"
"1405","44","16",0.5,45,34,89,1,750,880049,881546,882944,887834,888584,668046,200,750,-0.5,"/Volumes/Drive/Thesis/new_data/sub23/log_files/sub23_S2_ASTrain.xls"
"1406","45","36",0.5,57,18,65,2,683,899960,901457,902854,907744,908427,668046,200,683,-0.5,"/Volumes/Drive/Thesis/new_data/sub23/log_files/sub23_S2_ASTrain.xls"
"1407","46","10",0.5,42,37,69,1,904,919371,920868,922266,927272,928176,668046,300,904,-0.5,"/Volumes/Drive/Thesis/new_data/sub23/log_files/sub23_S2_ASTrain.xls"
"1408","47","53",0.5,57,16,75,2,675,938600,940097,941494,945985,946660,668046,-200,675,0.5,"/Volumes/Drive/Thesis/new_data/sub23/log_files/sub23_S2_ASTrain.xls"
"1409","48","122",-0.5,52,14,36,1,888,957396,958893,960290,965396,966284,668046,400,888,0.5,"/Volumes/Drive/Thesis/new_data/sub23/log_files/sub23_S2_ASTrain.xls"
"1410","49","111",-0.5,65,29,38,2,557,977522,979019,980417,985008,985565,668046,-100,557,-0.5,"/Volumes/Drive/Thesis/new_data/sub23/log_files/sub23_S2_ASTrain.xls"
"1411","50","97",-0.5,51,19,34,2,576,996318,997815,999213,1003504,1004080,668046,-400,576,-0.5,"/Volumes/Drive/Thesis/new_data/sub23/log_files/sub23_S2_ASTrain.xls"
"1412","51","119",-0.5,54,17,27,2,1208,1015514,1017011,1018408,1022799,1024007,668046,-300,1208,0.5,"/Volumes/Drive/Thesis/new_data/sub23/log_files/sub23_S2_ASTrain.xls"
"1413","52","121",-0.5,61,24,39,2,960,1034809,1036306,1037703,1042493,1043453,668046,100,960,0.5,"/Volumes/Drive/Thesis/new_data/sub23/log_files/sub23_S2_ASTrain.xls"
"1414","53","92",-0.5,83,21,64,1,830,1054403,1055900,1057297,1062404,1063234,668046,400,830,0.5,"/Volumes/Drive/Thesis/new_data/sub23/log_files/sub23_S2_ASTrain.xls"
"1415","54","60",0.5,34,29,53,2,740,1074430,1075927,1077324,1081915,1082655,668046,-100,740,0.5,"/Volumes/Drive/Thesis/new_data/sub23/log_files/sub23_S2_ASTrain.xls"
"1416","55","23",0.5,64,12,78,2,695,1093226,1094723,1096120,1100412,1101107,668046,-400,695,0.5,"/Volumes/Drive/Thesis/new_data/sub23/log_files/sub23_S2_ASTrain.xls"
"1417","56","105",-0.5,71,24,49,2,1153,1112022,1113519,1114916,1119407,1120560,668046,-200,1153,-0.5,"/Volumes/Drive/Thesis/new_data/sub23/log_files/sub23_S2_ASTrain.xls"
"1418","57","41",0.5,54,17,81,2,737,1131433,1132930,1134328,1138619,1139356,668046,-400,737,-0.5,"/Volumes/Drive/Thesis/new_data/sub23/log_files/sub23_S2_ASTrain.xls"
"1419","58","69",-0.5,78,31,45,2,1343,1150246,1151743,1153140,1157731,1159074,668046,-100,1343,-0.5,"/Volumes/Drive/Thesis/new_data/sub23/log_files/sub23_S2_ASTrain.xls"
"1420","59","101",-0.5,64,18,48,2,1261,1169840,1171337,1172735,1177625,1178886,668046,200,1261,-0.5,"/Volumes/Drive/Thesis/new_data/sub23/log_files/sub23_S2_ASTrain.xls"
"1421","60","42",0.5,52,19,61,1,771,1189135,1190632,1192030,1197020,1197791,668046,300,771,-0.5,"/Volumes/Drive/Thesis/new_data/sub23/log_files/sub23_S2_ASTrain.xls"
"1422","61","113",-0.5,82,19,65,2,1677,1208447,1209944,1211341,1215832,1217509,668046,-200,1677,0.5,"/Volumes/Drive/Thesis/new_data/sub23/log_files/sub23_S2_ASTrain.xls"
"1423","63","49",0.5,39,17,58,2,621,1247736,1249233,1250630,1255121,1255742,668046,-200,621,0.5,"/Volumes/Drive/Thesis/new_data/sub23/log_files/sub23_S2_ASTrain.xls"
"1424","64","90",-0.5,74,43,41,1,1571,1266648,1268145,1269542,1274333,1275904,668046,100,1571,0.5,"/Volumes/Drive/Thesis/new_data/sub23/log_files/sub23_S2_ASTrain.xls"
"1425","65","35",0.5,36,17,63,1,589,1317697,1319194,1320591,1325182,1325771,1317506,-100,589,-0.5,"/Volumes/Drive/Thesis/new_data/sub23/log_files/sub23_S2_ASTrain.xls"
"1426","66","14",0.5,48,21,71,1,679,1337008,1338505,1339903,1344294,1344973,1317506,-300,679,-0.5,"/Volumes/Drive/Thesis/new_data/sub23/log_files/sub23_S2_ASTrain.xls"
"1427","67","114",-0.5,82,28,52,1,639,1355705,1357202,1358599,1362990,1363629,1317506,-300,639,0.5,"/Volumes/Drive/Thesis/new_data/sub23/log_files/sub23_S2_ASTrain.xls"
"1428","68","103",-0.5,73,15,68,2,1441,1374517,1376014,1377411,1381703,1383144,1317506,-400,1441,-0.5,"/Volumes/Drive/Thesis/new_data/sub23/log_files/sub23_S2_ASTrain.xls"
"1429","69","94",-0.5,86,35,61,1,862,1393513,1395010,1396407,1401297,1402159,1317506,200,862,0.5,"/Volumes/Drive/Thesis/new_data/sub23/log_files/sub23_S2_ASTrain.xls"
"1430","70","88",-0.5,45,14,41,2,1387,1412708,1414205,1415602,1420193,1421580,1317506,-100,1387,0.5,"/Volumes/Drive/Thesis/new_data/sub23/log_files/sub23_S2_ASTrain.xls"
"1431","71","28",0.5,52,16,78,1,977,1431820,1433317,1434714,1439821,1440798,1317506,400,977,0.5,"/Volumes/Drive/Thesis/new_data/sub23/log_files/sub23_S2_ASTrain.xls"
"1432","72","118",-0.5,73,27,48,1,1006,1451431,1452928,1454325,1459432,1460438,1317506,400,1006,0.5,"/Volumes/Drive/Thesis/new_data/sub23/log_files/sub23_S2_ASTrain.xls"
"1433","73","93",-0.5,68,37,21,2,594,1471458,1472955,1474352,1478843,1479437,1317506,-200,594,0.5,"/Volumes/Drive/Thesis/new_data/sub23/log_files/sub23_S2_ASTrain.xls"
"1434","74","3",0.5,52,24,74,2,511,1490953,1492450,1493847,1498238,1498749,1317506,-300,511,-0.5,"/Volumes/Drive/Thesis/new_data/sub23/log_files/sub23_S2_ASTrain.xls"
"1435","75","65",-0.5,68,12,54,2,809,1510347,1511844,1513242,1517533,1518342,1317506,-400,809,-0.5,"/Volumes/Drive/Thesis/new_data/sub23/log_files/sub23_S2_ASTrain.xls"
"1436","76","17",0.5,62,14,78,2,958,1529343,1530840,1532237,1537227,1538185,1317506,300,958,0.5,"/Volumes/Drive/Thesis/new_data/sub23/log_files/sub23_S2_ASTrain.xls"
"1437","77","12",0.5,62,16,68,1,736,1549137,1550634,1552031,1556323,1557059,1317506,-400,736,-0.5,"/Volumes/Drive/Thesis/new_data/sub23/log_files/sub23_S2_ASTrain.xls"
"1438","79","57",0.5,54,19,71,2,652,1587361,1588858,1590255,1595046,1595698,1317506,100,652,0.5,"/Volumes/Drive/Thesis/new_data/sub23/log_files/sub23_S2_ASTrain.xls"
"1439","80","8",0.5,24,13,47,1,639,1606972,1608469,1609866,1614856,1615495,1317506,300,639,-0.5,"/Volumes/Drive/Thesis/new_data/sub23/log_files/sub23_S2_ASTrain.xls"
"1440","81","110",-0.5,86,18,58,1,1169,1626284,1627781,1629178,1633669,1634838,1317506,-200,1169,-0.5,"/Volumes/Drive/Thesis/new_data/sub23/log_files/sub23_S2_ASTrain.xls"
"1441","82","61",0.5,39,24,61,2,517,1645196,1646693,1648090,1652382,1652899,1317506,-400,517,0.5,"/Volumes/Drive/Thesis/new_data/sub23/log_files/sub23_S2_ASTrain.xls"
"1442","83","68",-0.5,46,14,34,1,580,1664308,1665805,1667202,1672209,1672789,1317506,300,580,-0.5,"/Volumes/Drive/Thesis/new_data/sub23/log_files/sub23_S2_ASTrain.xls"
"1443","84","48",0.5,49,24,71,1,598,1684318,1685816,1687213,1692003,1692601,1317506,100,598,-0.5,"/Volumes/Drive/Thesis/new_data/sub23/log_files/sub23_S2_ASTrain.xls"
"1444","85","37",0.5,46,28,64,2,487,1703331,1704828,1706225,1711332,1711819,1317506,400,487,-0.5,"/Volumes/Drive/Thesis/new_data/sub23/log_files/sub23_S2_ASTrain.xls"
"1445","86","98",-0.5,62,28,32,1,574,1722958,1724455,1725853,1730244,1730818,1317506,-300,574,-0.5,"/Volumes/Drive/Thesis/new_data/sub23/log_files/sub23_S2_ASTrain.xls"
"1446","87","126",-0.5,87,38,47,1,729,1741555,1743052,1744449,1749339,1750068,1317506,200,729,0.5,"/Volumes/Drive/Thesis/new_data/sub23/log_files/sub23_S2_ASTrain.xls"
"1447","88","26",0.5,31,28,69,1,779,1761349,1762846,1764243,1769350,1770129,1317506,400,779,0.5,"/Volumes/Drive/Thesis/new_data/sub23/log_files/sub23_S2_ASTrain.xls"
"1448","89","32",0.5,47,21,78,1,541,1781359,1782856,1784253,1788744,1789285,1317506,-200,541,0.5,"/Volumes/Drive/Thesis/new_data/sub23/log_files/sub23_S2_ASTrain.xls"
"1449","91","107",-0.5,81,13,78,2,727,1819650,1821147,1822544,1827135,1827862,1317506,-100,727,-0.5,"/Volumes/Drive/Thesis/new_data/sub23/log_files/sub23_S2_ASTrain.xls"
"1450","92","72",-0.5,79,21,68,1,586,1838545,1840043,1841440,1845931,1846517,1317506,-200,586,-0.5,"/Volumes/Drive/Thesis/new_data/sub23/log_files/sub23_S2_ASTrain.xls"
"1451","93","89",-0.5,54,12,32,1,543,1857757,1859254,1860652,1865442,1865985,1317506,100,543,0.5,"/Volumes/Drive/Thesis/new_data/sub23/log_files/sub23_S2_ASTrain.xls"
"1452","94","62",0.5,59,13,74,1,560,1876953,1878450,1879847,1884737,1885297,1317506,200,560,0.5,"/Volumes/Drive/Thesis/new_data/sub23/log_files/sub23_S2_ASTrain.xls"
"1453","95","58",0.5,54,18,74,1,656,1896747,1898244,1899641,1904531,1905187,1317506,200,656,0.5,"/Volumes/Drive/Thesis/new_data/sub23/log_files/sub23_S2_ASTrain.xls"
"1454","96","71",-0.5,67,14,51,2,844,1915842,1917339,1918736,1923327,1924171,1317506,-100,844,-0.5,"/Volumes/Drive/Thesis/new_data/sub23/log_files/sub23_S2_ASTrain.xls"
"1455","97","123",-0.5,62,13,59,2,575,1962300,1963797,1965194,1969984,1970559,1962202,100,575,0.5,"/Volumes/Drive/Thesis/new_data/sub23/log_files/sub23_S2_ASTrain.xls"
"1456","98","96",-0.5,56,15,31,1,499,1981894,1983391,1984788,1989778,1990277,1962202,300,499,0.5,"/Volumes/Drive/Thesis/new_data/sub23/log_files/sub23_S2_ASTrain.xls"
"1457","99","11",0.5,61,17,76,2,487,2001904,2003401,2004799,2009805,2010292,1962202,300,487,-0.5,"/Volumes/Drive/Thesis/new_data/sub23/log_files/sub23_S2_ASTrain.xls"
"1458","101","83",-0.5,48,23,23,2,1089,2041027,2042524,2043921,2048811,2049900,1962202,200,1089,0.5,"/Volumes/Drive/Thesis/new_data/sub23/log_files/sub23_S2_ASTrain.xls"
"1459","102","40",0.5,67,15,84,2,1214,2060421,2061918,2063316,2067607,2068821,1962202,-400,1214,-0.5,"/Volumes/Drive/Thesis/new_data/sub23/log_files/sub23_S2_ASTrain.xls"
"1460","103","78",-0.5,79,36,53,1,658,2079434,2080931,2082328,2086819,2087477,1962202,-200,658,-0.5,"/Volumes/Drive/Thesis/new_data/sub23/log_files/sub23_S2_ASTrain.xls"
"1461","104","15",0.5,47,31,76,1,806,2098629,2100126,2101523,2106014,2106820,1962202,-200,806,-0.5,"/Volumes/Drive/Thesis/new_data/sub23/log_files/sub23_S2_ASTrain.xls"
"1462","105","21",0.5,41,34,73,2,572,2117841,2119338,2120735,2125841,2126413,1962202,400,572,0.5,"/Volumes/Drive/Thesis/new_data/sub23/log_files/sub23_S2_ASTrain.xls"
"1463","106","85",-0.5,65,24,43,2,600,2137967,2139464,2140862,2145453,2146053,1962202,-100,600,0.5,"/Volumes/Drive/Thesis/new_data/sub23/log_files/sub23_S2_ASTrain.xls"
"1464","107","34",0.5,37,28,67,1,993,2156780,2158277,2159674,2164465,2165458,1962202,100,993,-0.5,"/Volumes/Drive/Thesis/new_data/sub23/log_files/sub23_S2_ASTrain.xls"
"1465","108","25",0.5,61,18,69,2,801,2175875,2177372,2178770,2183876,2184677,1962202,400,801,0.5,"/Volumes/Drive/Thesis/new_data/sub23/log_files/sub23_S2_ASTrain.xls"
"1466","109","54",0.5,47,35,80,1,985,2195503,2197000,2198397,2202988,2203973,1962202,-100,985,0.5,"/Volumes/Drive/Thesis/new_data/sub23/log_files/sub23_S2_ASTrain.xls"
"1467","110","30",0.5,46,32,68,1,1072,2215114,2216611,2218008,2222400,2223472,1962202,-300,1072,0.5,"/Volumes/Drive/Thesis/new_data/sub23/log_files/sub23_S2_ASTrain.xls"
"1468","111","6",0.5,52,13,67,1,725,2234027,2235524,2236921,2242027,2242752,1962202,400,725,-0.5,"/Volumes/Drive/Thesis/new_data/sub23/log_files/sub23_S2_ASTrain.xls"
"1469","112","39",0.5,48,27,73,2,1098,2254137,2255634,2257031,2261622,2262720,1962202,-100,1098,-0.5,"/Volumes/Drive/Thesis/new_data/sub23/log_files/sub23_S2_ASTrain.xls"
"1470","113","4",0.5,53,21,76,1,689,2273049,2274546,2275943,2280734,2281423,1962202,100,689,-0.5,"/Volumes/Drive/Thesis/new_data/sub23/log_files/sub23_S2_ASTrain.xls"
"1471","114","75",-0.5,84,52,42,2,996,2292261,2293758,2295155,2300145,2301141,1962202,300,996,-0.5,"/Volumes/Drive/Thesis/new_data/sub23/log_files/sub23_S2_ASTrain.xls"
"1472","115","51",0.5,37,25,72,2,566,2311556,2313053,2314450,2319074,2319640,1962202,-100,566,0.5,"/Volumes/Drive/Thesis/new_data/sub23/log_files/sub23_S2_ASTrain.xls"
"1473","116","108",-0.5,72,23,39,1,653,2330601,2332098,2333496,2337987,2338640,1962202,-200,653,-0.5,"/Volumes/Drive/Thesis/new_data/sub23/log_files/sub23_S2_ASTrain.xls"
"1474","117","59",0.5,43,28,81,2,555,2349314,2350811,2352209,2357099,2357654,1962202,200,555,0.5,"/Volumes/Drive/Thesis/new_data/sub23/log_files/sub23_S2_ASTrain.xls"
"1475","118","55",0.5,36,28,74,2,571,2369125,2370622,2372019,2377126,2377697,1962202,400,571,0.5,"/Volumes/Drive/Thesis/new_data/sub23/log_files/sub23_S2_ASTrain.xls"
"1476","119","115",-0.5,64,25,29,2,627,2389052,2390549,2391946,2396338,2396965,1962202,-300,627,0.5,"/Volumes/Drive/Thesis/new_data/sub23/log_files/sub23_S2_ASTrain.xls"
"1477","120","33",0.5,58,16,72,2,660,2408247,2409744,2411141,2415633,2416293,1962202,-200,660,-0.5,"/Volumes/Drive/Thesis/new_data/sub23/log_files/sub23_S2_ASTrain.xls"
"1478","121","20",0.5,51,24,65,1,553,2427642,2429139,2430536,2435427,2435980,1962202,200,553,0.5,"/Volumes/Drive/Thesis/new_data/sub23/log_files/sub23_S2_ASTrain.xls"
"1479","122","109",-0.5,75,26,47,1,1177,2446954,2448451,2449848,2454239,2455416,1962202,-300,1177,-0.5,"/Volumes/Drive/Thesis/new_data/sub23/log_files/sub23_S2_ASTrain.xls"
"1480","123","86",-0.5,75,13,64,1,760,2466049,2467546,2468943,2473734,2474494,1962202,100,760,0.5,"/Volumes/Drive/Thesis/new_data/sub23/log_files/sub23_S2_ASTrain.xls"
"1481","124","73",-0.5,83,51,34,2,632,2485144,2486641,2488039,2492330,2492962,1962202,-400,632,-0.5,"/Volumes/Drive/Thesis/new_data/sub23/log_files/sub23_S2_ASTrain.xls"
"1482","125","125",-0.5,75,38,39,2,1084,2503857,2505354,2506752,2511143,2512227,1962202,-300,1084,0.5,"/Volumes/Drive/Thesis/new_data/sub23/log_files/sub23_S2_ASTrain.xls"
"1483","126","104",-0.5,51,16,25,1,1023,2523169,2524666,2526063,2530953,2531976,1962202,200,1023,-0.5,"/Volumes/Drive/Thesis/new_data/sub23/log_files/sub23_S2_ASTrain.xls"
"1484","127","67",-0.5,47,13,24,2,695,2542564,2544061,2545458,2549749,2550444,1962202,-400,695,-0.5,"/Volumes/Drive/Thesis/new_data/sub23/log_files/sub23_S2_ASTrain.xls"
"1485","128","117",-0.5,72,29,41,2,1552,2561659,2563156,2564553,2568845,2570397,1962202,-400,1552,0.5,"/Volumes/Drive/Thesis/new_data/sub23/log_files/sub23_S2_ASTrain.xls"
"1486","1","62",0.5,59,13,74,1,1421,22636,24133,25530,30637,32058,22456,400,1421,0.5,"/Volumes/Drive/Thesis/new_data/sub25/log_files/sub25_S2_ASTrain.xls"
"1487","2","38",0.5,39,25,74,1,1284,42463,43960,45357,50148,51432,22456,100,1284,-0.5,"/Volumes/Drive/Thesis/new_data/sub25/log_files/sub25_S2_ASTrain.xls"
"1488","3","43",0.5,43,19,64,2,778,62074,63571,64968,69559,70337,22456,-100,778,-0.5,"/Volumes/Drive/Thesis/new_data/sub25/log_files/sub25_S2_ASTrain.xls"
"1489","4","121",-0.5,61,24,39,2,929,81070,82567,83964,88455,89384,22456,-200,929,0.5,"/Volumes/Drive/Thesis/new_data/sub25/log_files/sub25_S2_ASTrain.xls"
"1490","5","24",0.5,61,23,82,1,656,99866,101363,102760,107867,108523,22456,400,656,0.5,"/Volumes/Drive/Thesis/new_data/sub25/log_files/sub25_S2_ASTrain.xls"
"1491","6","95",-0.5,68,15,51,2,834,119294,120791,122188,126579,127413,22456,-300,834,0.5,"/Volumes/Drive/Thesis/new_data/sub25/log_files/sub25_S2_ASTrain.xls"
"1492","7","51",0.5,37,25,72,2,644,137907,139404,140801,145691,146335,22456,200,644,0.5,"/Volumes/Drive/Thesis/new_data/sub25/log_files/sub25_S2_ASTrain.xls"
"1493","8","73",-0.5,83,51,34,2,685,157202,158699,160096,165086,165771,22456,300,685,-0.5,"/Volumes/Drive/Thesis/new_data/sub25/log_files/sub25_S2_ASTrain.xls"
"1494","9","14",0.5,48,21,71,1,521,176613,178110,179524,184531,185052,22456,300,521,-0.5,"/Volumes/Drive/Thesis/new_data/sub25/log_files/sub25_S2_ASTrain.xls"
"1495","10","91",-0.5,74,42,42,2,636,196457,197954,199352,203743,204379,22456,-300,636,0.5,"/Volumes/Drive/Thesis/new_data/sub25/log_files/sub25_S2_ASTrain.xls"
"1496","11","71",-0.5,67,14,51,2,602,215070,216567,217965,222855,223457,22456,200,602,-0.5,"/Volumes/Drive/Thesis/new_data/sub25/log_files/sub25_S2_ASTrain.xls"
"1497","12","46",0.5,29,14,41,1,515,234681,236178,237576,242582,243097,22456,300,515,-0.5,"/Volumes/Drive/Thesis/new_data/sub25/log_files/sub25_S2_ASTrain.xls"
"1498","13","12",0.5,62,16,68,1,1155,254209,255706,257103,261894,263049,22456,100,1155,-0.5,"/Volumes/Drive/Thesis/new_data/sub25/log_files/sub25_S2_ASTrain.xls"
"1499","15","105",-0.5,71,24,49,2,525,293115,294612,296010,301116,301641,22456,400,525,-0.5,"/Volumes/Drive/Thesis/new_data/sub25/log_files/sub25_S2_ASTrain.xls"
"1500","16","2",0.5,41,23,74,1,648,313126,314672,316070,320461,321109,22456,-300,648,-0.5,"/Volumes/Drive/Thesis/new_data/sub25/log_files/sub25_S2_ASTrain.xls"
"1501","17","30",0.5,46,32,68,1,699,332487,333984,335381,339972,340671,22456,-100,699,0.5,"/Volumes/Drive/Thesis/new_data/sub25/log_files/sub25_S2_ASTrain.xls"
"1502","18","116",-0.5,53,17,46,1,648,351399,352897,354294,358585,359233,22456,-400,648,0.5,"/Volumes/Drive/Thesis/new_data/sub25/log_files/sub25_S2_ASTrain.xls"
"1503","19","83",-0.5,48,23,23,2,652,370711,372208,373605,378096,378748,22456,-200,652,0.5,"/Volumes/Drive/Thesis/new_data/sub25/log_files/sub25_S2_ASTrain.xls"
"1504","20","54",0.5,47,35,80,1,630,389723,391220,392618,397508,398138,22456,200,630,0.5,"/Volumes/Drive/Thesis/new_data/sub25/log_files/sub25_S2_ASTrain.xls"
"1505","21","50",0.5,49,25,72,1,661,408819,410316,411713,416304,416965,22456,-100,661,0.5,"/Volumes/Drive/Thesis/new_data/sub25/log_files/sub25_S2_ASTrain.xls"
"1506","22","6",0.5,52,13,67,1,524,427914,429411,430808,435300,435824,22456,-200,524,-0.5,"/Volumes/Drive/Thesis/new_data/sub25/log_files/sub25_S2_ASTrain.xls"
"1507","23","108",-0.5,72,23,39,1,509,447425,448922,450320,454611,455120,22456,-400,509,-0.5,"/Volumes/Drive/Thesis/new_data/sub25/log_files/sub25_S2_ASTrain.xls"
"1508","24","40",0.5,67,15,84,1,488,466621,468118,469515,474006,474494,22456,-200,488,-0.5,"/Volumes/Drive/Thesis/new_data/sub25/log_files/sub25_S2_ASTrain.xls"
"1509","25","113",-0.5,82,19,65,2,1539,485832,487329,488727,493517,495056,22456,100,1539,0.5,"/Volumes/Drive/Thesis/new_data/sub25/log_files/sub25_S2_ASTrain.xls"
"1510","26","109",-0.5,75,26,47,2,580,505427,506924,508321,513428,514008,22456,400,580,-0.5,"/Volumes/Drive/Thesis/new_data/sub25/log_files/sub25_S2_ASTrain.xls"
"1511","27","32",0.5,47,21,78,1,630,524755,526252,527649,532440,533070,22456,100,630,0.5,"/Volumes/Drive/Thesis/new_data/sub25/log_files/sub25_S2_ASTrain.xls"
"1512","28","100",-0.5,74,35,49,1,846,543851,545348,546745,551036,551882,22456,-400,846,-0.5,"/Volumes/Drive/Thesis/new_data/sub25/log_files/sub25_S2_ASTrain.xls"
"1513","29","84",-0.5,89,41,46,1,717,563046,564543,565940,570930,571647,22456,300,717,0.5,"/Volumes/Drive/Thesis/new_data/sub25/log_files/sub25_S2_ASTrain.xls"
"1514","30","114",-0.5,82,28,52,1,1010,582757,584254,585651,590042,591052,22456,-300,1010,0.5,"/Volumes/Drive/Thesis/new_data/sub25/log_files/sub25_S2_ASTrain.xls"
"1515","31","67",-0.5,47,13,24,2,600,602151,603648,605046,609936,610536,22456,200,600,-0.5,"/Volumes/Drive/Thesis/new_data/sub25/log_files/sub25_S2_ASTrain.xls"
"1516","32","70",-0.5,68,23,35,1,503,621563,623060,624457,629048,629551,22456,-100,503,-0.5,"/Volumes/Drive/Thesis/new_data/sub25/log_files/sub25_S2_ASTrain.xls"
"1517","33","63",0.5,47,24,61,2,575,686101,687598,688996,693786,694361,686002,100,575,0.5,"/Volumes/Drive/Thesis/new_data/sub25/log_files/sub25_S2_ASTrain.xls"
"1518","34","19",0.5,34,23,67,2,648,705696,707193,708590,713697,714345,686002,400,648,0.5,"/Volumes/Drive/Thesis/new_data/sub25/log_files/sub25_S2_ASTrain.xls"
"1519","35","26",0.5,31,28,69,1,616,725224,726721,728118,732509,733125,686002,-300,616,0.5,"/Volumes/Drive/Thesis/new_data/sub25/log_files/sub25_S2_ASTrain.xls"
"1520","36","89",-0.5,54,12,32,2,698,744635,746132,747529,752536,753234,686002,300,698,0.5,"/Volumes/Drive/Thesis/new_data/sub25/log_files/sub25_S2_ASTrain.xls"
"1521","37","58",0.5,54,18,74,1,694,764163,765660,767057,772164,772858,686002,400,694,0.5,"/Volumes/Drive/Thesis/new_data/sub25/log_files/sub25_S2_ASTrain.xls"
"1522","38","80",-0.5,59,18,31,1,545,783674,785171,786568,791359,791904,686002,100,545,-0.5,"/Volumes/Drive/Thesis/new_data/sub25/log_files/sub25_S2_ASTrain.xls"
"1523","39","123",-0.5,62,13,59,2,625,803269,804766,806163,811153,811778,686002,300,625,0.5,"/Volumes/Drive/Thesis/new_data/sub25/log_files/sub25_S2_ASTrain.xls"
"1524","40","99",-0.5,83,25,48,2,535,822963,824460,825857,830149,830684,686002,-400,535,-0.5,"/Volumes/Drive/Thesis/new_data/sub25/log_files/sub25_S2_ASTrain.xls"
"1525","41","101",-0.5,64,18,48,2,869,841576,843073,844470,848861,849730,686002,-300,869,-0.5,"/Volumes/Drive/Thesis/new_data/sub25/log_files/sub25_S2_ASTrain.xls"
"1526","42","4",0.5,53,21,76,1,906,860887,862385,863782,868073,868979,686002,-400,906,-0.5,"/Volumes/Drive/Thesis/new_data/sub25/log_files/sub25_S2_ASTrain.xls"
"1527","43","96",-0.5,56,15,31,1,439,879700,881197,882594,887185,887624,686002,-100,439,0.5,"/Volumes/Drive/Thesis/new_data/sub25/log_files/sub25_S2_ASTrain.xls"
"1528","44","90",-0.5,74,43,41,1,483,898513,900010,901407,905698,906181,686002,-400,483,0.5,"/Volumes/Drive/Thesis/new_data/sub25/log_files/sub25_S2_ASTrain.xls"
"1529","45","119",-0.5,54,17,27,2,1042,917525,919022,920419,925310,926352,686002,200,1042,0.5,"/Volumes/Drive/Thesis/new_data/sub25/log_files/sub25_S2_ASTrain.xls"
"1530","46","64",0.5,38,14,62,1,1526,937419,938916,940313,944904,946430,686002,-100,1526,0.5,"/Volumes/Drive/Thesis/new_data/sub25/log_files/sub25_S2_ASTrain.xls"
"1531","47","25",0.5,61,18,69,2,777,956315,957812,959209,964199,964976,686002,300,777,0.5,"/Volumes/Drive/Thesis/new_data/sub25/log_files/sub25_S2_ASTrain.xls"
"1532","48","48",0.5,49,24,71,2,558,975510,977007,978404,983511,984069,686002,400,558,-0.5,"/Volumes/Drive/Thesis/new_data/sub25/log_files/sub25_S2_ASTrain.xls"
"1533","49","34",0.5,37,28,67,1,1512,995121,996618,998015,1002806,1004318,686002,100,1512,-0.5,"/Volumes/Drive/Thesis/new_data/sub25/log_files/sub25_S2_ASTrain.xls"
"1534","50","13",0.5,58,21,69,2,649,1014133,1015630,1017027,1021419,1022068,686002,-300,649,-0.5,"/Volumes/Drive/Thesis/new_data/sub25/log_files/sub25_S2_ASTrain.xls"
"1535","52","79",-0.5,49,17,34,2,501,1052540,1054037,1055434,1060424,1060925,686002,300,501,-0.5,"/Volumes/Drive/Thesis/new_data/sub25/log_files/sub25_S2_ASTrain.xls"
"1536","53","127",-0.5,65,27,48,2,477,1072451,1073948,1075345,1080135,1080612,686002,100,477,0.5,"/Volumes/Drive/Thesis/new_data/sub25/log_files/sub25_S2_ASTrain.xls"
"1537","54","126",-0.5,87,38,47,1,702,1091945,1093442,1094856,1099347,1100049,686002,-200,702,0.5,"/Volumes/Drive/Thesis/new_data/sub25/log_files/sub25_S2_ASTrain.xls"
"1538","55","10",0.5,42,37,69,1,524,1111373,1112870,1114267,1118759,1119283,686002,-200,524,-0.5,"/Volumes/Drive/Thesis/new_data/sub25/log_files/sub25_S2_ASTrain.xls"
"1539","56","56",0.5,58,17,65,1,594,1130169,1131666,1133063,1137954,1138548,686002,200,594,0.5,"/Volumes/Drive/Thesis/new_data/sub25/log_files/sub25_S2_ASTrain.xls"
"1540","57","17",0.5,62,14,78,2,745,1150063,1151560,1152957,1157349,1158094,686002,-300,745,0.5,"/Volumes/Drive/Thesis/new_data/sub25/log_files/sub25_S2_ASTrain.xls"
"1541","59","94",-0.5,86,35,61,1,522,1188054,1189551,1190949,1195539,1196061,686002,-100,522,0.5,"/Volumes/Drive/Thesis/new_data/sub25/log_files/sub25_S2_ASTrain.xls"
"1542","60","16",0.5,45,34,89,1,818,1206867,1208364,1209761,1214352,1215170,686002,-100,818,-0.5,"/Volumes/Drive/Thesis/new_data/sub25/log_files/sub25_S2_ASTrain.xls"
"1543","61","75",-0.5,84,52,42,1,911,1226278,1227775,1229173,1233664,1234575,686002,-200,911,-0.5,"/Volumes/Drive/Thesis/new_data/sub25/log_files/sub25_S2_ASTrain.xls"
"1544","62","37",0.5,46,28,64,2,563,1245573,1247070,1248468,1253574,1254137,686002,400,563,-0.5,"/Volumes/Drive/Thesis/new_data/sub25/log_files/sub25_S2_ASTrain.xls"
"1545","64","112",-0.5,57,18,49,1,1240,1284579,1286076,1287473,1292364,1293604,686002,200,1240,-0.5,"/Volumes/Drive/Thesis/new_data/sub25/log_files/sub25_S2_ASTrain.xls"
"1546","65","7",0.5,42,34,78,2,480,1339703,1341200,1342597,1347388,1347868,1339583,100,480,-0.5,"/Volumes/Drive/Thesis/new_data/sub25/log_files/sub25_S2_ASTrain.xls"
"1547","66","55",0.5,36,28,74,2,507,1359397,1360894,1362292,1367282,1367789,1339583,300,507,0.5,"/Volumes/Drive/Thesis/new_data/sub25/log_files/sub25_S2_ASTrain.xls"
"1548","67","49",0.5,39,17,58,2,665,1379208,1380705,1382102,1387092,1387757,1339583,300,665,0.5,"/Volumes/Drive/Thesis/new_data/sub25/log_files/sub25_S2_ASTrain.xls"
"1549","68","97",-0.5,51,19,34,2,443,1398719,1400216,1401613,1406204,1406647,1339583,-100,443,-0.5,"/Volumes/Drive/Thesis/new_data/sub25/log_files/sub25_S2_ASTrain.xls"
"1550","69","44",0.5,43,29,74,1,671,1417715,1419212,1420609,1425100,1425771,1339583,-200,671,-0.5,"/Volumes/Drive/Thesis/new_data/sub25/log_files/sub25_S2_ASTrain.xls"
"1551","70","76",-0.5,53,21,34,1,1430,1436527,1438024,1439422,1444528,1445958,1339583,400,1430,-0.5,"/Volumes/Drive/Thesis/new_data/sub25/log_files/sub25_S2_ASTrain.xls"
"1552","72","124",-0.5,72,24,38,1,558,1474951,1476448,1477845,1482336,1482894,1339583,-200,558,0.5,"/Volumes/Drive/Thesis/new_data/sub25/log_files/sub25_S2_ASTrain.xls"
"1553","73","20",0.5,51,24,65,1,643,1494246,1495743,1497140,1501532,1502175,1339583,-300,643,0.5,"/Volumes/Drive/Thesis/new_data/sub25/log_files/sub25_S2_ASTrain.xls"
"1554","74","107",-0.5,81,13,78,2,1689,1513342,1514839,1516236,1521126,1522815,1339583,200,1689,-0.5,"/Volumes/Drive/Thesis/new_data/sub25/log_files/sub25_S2_ASTrain.xls"
"1555","75","103",-0.5,73,15,68,2,527,1533036,1534533,1535930,1541037,1541564,1339583,400,527,-0.5,"/Volumes/Drive/Thesis/new_data/sub25/log_files/sub25_S2_ASTrain.xls"
"1556","76","23",0.5,64,12,78,2,531,1552547,1554044,1555441,1560548,1561079,1339583,400,531,0.5,"/Volumes/Drive/Thesis/new_data/sub25/log_files/sub25_S2_ASTrain.xls"
"1557","77","78",-0.5,79,36,53,1,478,1572474,1573971,1575368,1579959,1580437,1339583,-100,478,-0.5,"/Volumes/Drive/Thesis/new_data/sub25/log_files/sub25_S2_ASTrain.xls"
"1558","78","102",-0.5,84,35,47,1,635,1591570,1593067,1594464,1598755,1599390,1339583,-400,635,-0.5,"/Volumes/Drive/Thesis/new_data/sub25/log_files/sub25_S2_ASTrain.xls"
"1559","79","69",-0.5,78,31,45,2,516,1610582,1612079,1613476,1618483,1618999,1339583,300,516,-0.5,"/Volumes/Drive/Thesis/new_data/sub25/log_files/sub25_S2_ASTrain.xls"
"1560","80","88",-0.5,45,14,41,1,450,1629910,1631407,1632804,1637595,1638045,1339583,100,450,0.5,"/Volumes/Drive/Thesis/new_data/sub25/log_files/sub25_S2_ASTrain.xls"
"1561","81","22",0.5,31,23,56,1,455,1649022,1650519,1651916,1656308,1656763,1339583,-300,455,0.5,"/Volumes/Drive/Thesis/new_data/sub25/log_files/sub25_S2_ASTrain.xls"
"1562","82","65",-0.5,68,12,54,2,565,1668334,1669831,1671228,1675619,1676184,1339583,-300,565,-0.5,"/Volumes/Drive/Thesis/new_data/sub25/log_files/sub25_S2_ASTrain.xls"
"1563","83","8",0.5,24,13,47,1,450,1687745,1689242,1690639,1695530,1695980,1339583,200,450,-0.5,"/Volumes/Drive/Thesis/new_data/sub25/log_files/sub25_S2_ASTrain.xls"
"1564","84","61",0.5,39,24,61,2,391,1707656,1709153,1710550,1715041,1715432,1339583,-200,391,0.5,"/Volumes/Drive/Thesis/new_data/sub25/log_files/sub25_S2_ASTrain.xls"
"1565","85","128",-0.5,75,27,38,1,556,1726851,1728348,1729745,1734735,1735291,1339583,300,556,0.5,"/Volumes/Drive/Thesis/new_data/sub25/log_files/sub25_S2_ASTrain.xls"
"1566","86","42",0.5,52,19,61,1,608,1746262,1747759,1749156,1753448,1754056,1339583,-400,608,-0.5,"/Volumes/Drive/Thesis/new_data/sub25/log_files/sub25_S2_ASTrain.xls"
"1567","87","33",0.5,58,16,72,2,461,1764958,1766455,1767853,1772344,1772805,1339583,-200,461,-0.5,"/Volumes/Drive/Thesis/new_data/sub25/log_files/sub25_S2_ASTrain.xls"
"1568","88","81",-0.5,76,24,54,2,447,1783954,1785451,1786848,1791639,1792086,1339583,100,447,0.5,"/Volumes/Drive/Thesis/new_data/sub25/log_files/sub25_S2_ASTrain.xls"
"1569","89","39",0.5,48,27,73,2,532,1803049,1804546,1805944,1810834,1811366,1339583,200,532,-0.5,"/Volumes/Drive/Thesis/new_data/sub25/log_files/sub25_S2_ASTrain.xls"
"1570","90","115",-0.5,64,25,29,2,654,1822161,1823659,1825056,1829946,1830600,1339583,200,654,0.5,"/Volumes/Drive/Thesis/new_data/sub25/log_files/sub25_S2_ASTrain.xls"
"1571","91","93",-0.5,68,37,21,2,613,1841972,1843469,1844866,1849158,1849771,1339583,-400,613,0.5,"/Volumes/Drive/Thesis/new_data/sub25/log_files/sub25_S2_ASTrain.xls"
"1572","92","85",-0.5,65,24,43,2,425,1861267,1862764,1864161,1868752,1869177,1339583,-100,425,0.5,"/Volumes/Drive/Thesis/new_data/sub25/log_files/sub25_S2_ASTrain.xls"
"1573","93","27",0.5,41,17,56,2,552,1880862,1882359,1883756,1888546,1889098,1339583,100,552,0.5,"/Volumes/Drive/Thesis/new_data/sub25/log_files/sub25_S2_ASTrain.xls"
"1574","95","5",0.5,43,14,67,2,767,1919684,1921181,1922579,1926970,1927737,1339583,-300,767,-0.5,"/Volumes/Drive/Thesis/new_data/sub25/log_files/sub25_S2_ASTrain.xls"
"1575","96","11",0.5,61,17,76,2,632,1938996,1940493,1941890,1946182,1946814,1339583,-400,632,-0.5,"/Volumes/Drive/Thesis/new_data/sub25/log_files/sub25_S2_ASTrain.xls"
"1576","97","82",-0.5,48,14,32,1,583,1991276,1992773,1994170,1998761,1999344,1991179,-100,583,0.5,"/Volumes/Drive/Thesis/new_data/sub25/log_files/sub25_S2_ASTrain.xls"
"1577","100","21",0.5,41,34,73,2,556,2048994,2050491,2051889,2056879,2057435,1991179,300,556,0.5,"/Volumes/Drive/Thesis/new_data/sub25/log_files/sub25_S2_ASTrain.xls"
"1578","101","106",-0.5,52,13,37,1,828,2068406,2069903,2071300,2075591,2076419,1991179,-400,828,-0.5,"/Volumes/Drive/Thesis/new_data/sub25/log_files/sub25_S2_ASTrain.xls"
"1579","102","47",0.5,49,23,62,2,475,2087501,2088998,2090395,2094787,2095262,1991179,-300,475,-0.5,"/Volumes/Drive/Thesis/new_data/sub25/log_files/sub25_S2_ASTrain.xls"
"1580","103","57",0.5,54,19,71,2,492,2106597,2108094,2109491,2114597,2115089,1991179,400,492,0.5,"/Volumes/Drive/Thesis/new_data/sub25/log_files/sub25_S2_ASTrain.xls"
"1581","104","122",-0.5,52,14,36,1,671,2126607,2128104,2129501,2133793,2134464,1991179,-400,671,0.5,"/Volumes/Drive/Thesis/new_data/sub25/log_files/sub25_S2_ASTrain.xls"
"1582","105","125",-0.5,75,38,39,2,1505,2145220,2146717,2148114,2152505,2154010,1991179,-300,1505,0.5,"/Volumes/Drive/Thesis/new_data/sub25/log_files/sub25_S2_ASTrain.xls"
"1583","106","66",-0.5,86,41,43,1,552,2164631,2166128,2167526,2171817,2172369,1991179,-400,552,-0.5,"/Volumes/Drive/Thesis/new_data/sub25/log_files/sub25_S2_ASTrain.xls"
"1584","107","52",0.5,46,27,63,1,466,2183943,2185490,2186887,2191777,2192243,1991179,200,466,0.5,"/Volumes/Drive/Thesis/new_data/sub25/log_files/sub25_S2_ASTrain.xls"
"1585","108","92",-0.5,83,21,64,1,597,2203205,2204702,2206099,2210989,2211586,1991179,200,597,0.5,"/Volumes/Drive/Thesis/new_data/sub25/log_files/sub25_S2_ASTrain.xls"
"1586","109","28",0.5,52,16,78,1,420,2222999,2224496,2225893,2230384,2230804,1991179,-200,420,0.5,"/Volumes/Drive/Thesis/new_data/sub25/log_files/sub25_S2_ASTrain.xls"
"1587","110","29",0.5,45,14,57,2,545,2241911,2243408,2244805,2249696,2250241,1991179,200,545,0.5,"/Volumes/Drive/Thesis/new_data/sub25/log_files/sub25_S2_ASTrain.xls"
"1588","111","74",-0.5,63,12,41,1,687,2261506,2263003,2264400,2269506,2270193,1991179,400,687,-0.5,"/Volumes/Drive/Thesis/new_data/sub25/log_files/sub25_S2_ASTrain.xls"
"1589","112","77",-0.5,86,25,71,2,536,2281433,2282930,2284343,2289234,2289770,1991179,200,536,-0.5,"/Volumes/Drive/Thesis/new_data/sub25/log_files/sub25_S2_ASTrain.xls"
"1590","113","1",0.5,51,23,64,2,478,2300861,2302358,2303755,2308745,2309223,1991179,300,478,-0.5,"/Volumes/Drive/Thesis/new_data/sub25/log_files/sub25_S2_ASTrain.xls"
"1591","114","120",-0.5,71,35,46,1,645,2320255,2321753,2323150,2328140,2328785,1991179,300,645,0.5,"/Volumes/Drive/Thesis/new_data/sub25/log_files/sub25_S2_ASTrain.xls"
"1592","115","111",-0.5,65,29,38,2,577,2340050,2341547,2342944,2347535,2348112,1991179,-100,577,-0.5,"/Volumes/Drive/Thesis/new_data/sub25/log_files/sub25_S2_ASTrain.xls"
"1593","116","87",-0.5,86,24,52,2,546,2358945,2360442,2361840,2366331,2366877,1991179,-200,546,0.5,"/Volumes/Drive/Thesis/new_data/sub25/log_files/sub25_S2_ASTrain.xls"
"1594","117","60",0.5,34,29,53,1,497,2377941,2379438,2380835,2385942,2386439,1991179,400,497,0.5,"/Volumes/Drive/Thesis/new_data/sub25/log_files/sub25_S2_ASTrain.xls"
"1595","118","118",-0.5,73,27,48,1,575,2397552,2399049,2400446,2404738,2405313,1991179,-400,575,0.5,"/Volumes/Drive/Thesis/new_data/sub25/log_files/sub25_S2_ASTrain.xls"
"1596","119","36",0.5,57,18,65,1,639,2416548,2418045,2419442,2424033,2424672,1991179,-100,639,-0.5,"/Volumes/Drive/Thesis/new_data/sub25/log_files/sub25_S2_ASTrain.xls"
"1597","120","86",-0.5,75,13,64,1,423,2435360,2436857,2438254,2443045,2443468,1991179,100,423,0.5,"/Volumes/Drive/Thesis/new_data/sub25/log_files/sub25_S2_ASTrain.xls"
"1598","121","31",0.5,67,12,69,2,1176,2454372,2455869,2457267,2462057,2463233,1991179,100,1176,0.5,"/Volumes/Drive/Thesis/new_data/sub25/log_files/sub25_S2_ASTrain.xls"
"1599","122","35",0.5,36,17,63,2,899,2473867,2475364,2476761,2481552,2482451,1991179,100,899,-0.5,"/Volumes/Drive/Thesis/new_data/sub25/log_files/sub25_S2_ASTrain.xls"
"1600","123","15",0.5,47,31,76,2,787,2493478,2494975,2496372,2501163,2501950,1991179,100,787,-0.5,"/Volumes/Drive/Thesis/new_data/sub25/log_files/sub25_S2_ASTrain.xls"
"1601","124","9",0.5,24,15,37,2,537,2512690,2514187,2515584,2519975,2520512,1991179,-300,537,-0.5,"/Volumes/Drive/Thesis/new_data/sub25/log_files/sub25_S2_ASTrain.xls"
"1602","125","3",0.5,52,24,74,2,1120,2531303,2532800,2534197,2538688,2539808,1991179,-200,1120,-0.5,"/Volumes/Drive/Thesis/new_data/sub25/log_files/sub25_S2_ASTrain.xls"
"1603","126","110",-0.5,86,18,58,1,1316,2550315,2551812,2553209,2557601,2558917,1991179,-300,1316,-0.5,"/Volumes/Drive/Thesis/new_data/sub25/log_files/sub25_S2_ASTrain.xls"
"1604","127","68",-0.5,46,14,34,1,529,2569627,2571124,2572521,2577012,2577541,1991179,-200,529,-0.5,"/Volumes/Drive/Thesis/new_data/sub25/log_files/sub25_S2_ASTrain.xls"
"1605","128","59",0.5,43,28,81,2,972,2589121,2590618,2592016,2597006,2597978,1991179,300,972,0.5,"/Volumes/Drive/Thesis/new_data/sub25/log_files/sub25_S2_ASTrain.xls"
"1606","1","114",-0.5,82,28,52,1,1495,24216,25713,27111,31502,32997,24103,-300,1495,0.5,"/Volumes/Drive/Thesis/new_data/sub28/log_files/sub28_S2_ASTrain.xls"
"1607","3","88",-0.5,45,14,41,1,918,62108,63605,65002,70109,71027,24103,400,918,0.5,"/Volumes/Drive/Thesis/new_data/sub28/log_files/sub28_S2_ASTrain.xls"
"1608","4","3",0.5,52,24,74,2,925,82135,83632,85029,89321,90246,24103,-400,925,-0.5,"/Volumes/Drive/Thesis/new_data/sub28/log_files/sub28_S2_ASTrain.xls"
"1609","5","36",0.5,57,18,65,1,858,101430,102927,104324,109215,110073,24103,200,858,-0.5,"/Volumes/Drive/Thesis/new_data/sub28/log_files/sub28_S2_ASTrain.xls"
"1610","6","52",0.5,46,27,63,1,806,121125,122622,124019,128610,129416,24103,-100,806,0.5,"/Volumes/Drive/Thesis/new_data/sub28/log_files/sub28_S2_ASTrain.xls"
"1611","7","25",0.5,61,18,69,2,1585,140021,141518,142915,147206,148791,24103,-400,1585,0.5,"/Volumes/Drive/Thesis/new_data/sub28/log_files/sub28_S2_ASTrain.xls"
"1612","8","79",-0.5,49,17,34,2,825,159133,160630,162027,166418,167243,24103,-300,825,-0.5,"/Volumes/Drive/Thesis/new_data/sub28/log_files/sub28_S2_ASTrain.xls"
"1613","9","105",-0.5,71,24,49,2,1176,178228,179725,181123,185614,186790,24103,-200,1176,-0.5,"/Volumes/Drive/Thesis/new_data/sub28/log_files/sub28_S2_ASTrain.xls"
"1614","10","44",0.5,43,29,74,2,816,197424,198921,200318,205208,206024,24103,200,816,-0.5,"/Volumes/Drive/Thesis/new_data/sub28/log_files/sub28_S2_ASTrain.xls"
"1615","11","62",0.5,59,13,74,2,1528,216835,218332,219730,224720,226248,24103,300,1528,0.5,"/Volumes/Drive/Thesis/new_data/sub28/log_files/sub28_S2_ASTrain.xls"
"1616","12","54",0.5,47,35,80,1,1373,236629,238127,239524,243915,245288,24103,-300,1373,0.5,"/Volumes/Drive/Thesis/new_data/sub28/log_files/sub28_S2_ASTrain.xls"
"1617","13","75",-0.5,84,52,42,2,939,255226,256723,258120,262911,263850,24103,100,939,-0.5,"/Volumes/Drive/Thesis/new_data/sub28/log_files/sub28_S2_ASTrain.xls"
"1618","14","87",-0.5,86,24,52,2,871,274322,275819,277216,282322,283193,24103,400,871,0.5,"/Volumes/Drive/Thesis/new_data/sub28/log_files/sub28_S2_ASTrain.xls"
"1619","15","70",-0.5,68,23,35,1,1014,294349,295846,297243,302350,303364,24103,400,1014,-0.5,"/Volumes/Drive/Thesis/new_data/sub28/log_files/sub28_S2_ASTrain.xls"
"1620","16","89",-0.5,54,12,32,2,890,314176,315673,317070,321661,322551,24103,-100,890,0.5,"/Volumes/Drive/Thesis/new_data/sub28/log_files/sub28_S2_ASTrain.xls"
"1621","17","28",0.5,52,16,78,1,1375,333787,335284,336682,340973,342348,24103,-400,1375,0.5,"/Volumes/Drive/Thesis/new_data/sub28/log_files/sub28_S2_ASTrain.xls"
"1622","18","5",0.5,43,14,67,2,870,352484,353981,355378,360368,361238,24103,300,870,-0.5,"/Volumes/Drive/Thesis/new_data/sub28/log_files/sub28_S2_ASTrain.xls"
"1623","19","104",-0.5,51,16,25,1,1373,371696,373193,374590,379380,380753,24103,100,1373,-0.5,"/Volumes/Drive/Thesis/new_data/sub28/log_files/sub28_S2_ASTrain.xls"
"1624","21","128",-0.5,75,27,38,2,1288,410486,411983,413380,418370,419658,24103,300,1288,0.5,"/Volumes/Drive/Thesis/new_data/sub28/log_files/sub28_S2_ASTrain.xls"
"1625","22","116",-0.5,53,17,46,1,817,430496,431993,433390,438497,439314,24103,400,817,0.5,"/Volumes/Drive/Thesis/new_data/sub28/log_files/sub28_S2_ASTrain.xls"
"1626","23","23",0.5,64,12,78,2,1289,450523,452020,453417,458008,459297,24103,-100,1289,0.5,"/Volumes/Drive/Thesis/new_data/sub28/log_files/sub28_S2_ASTrain.xls"
"1627","24","46",0.5,29,14,41,1,1284,469519,471016,472413,476904,478188,24103,-200,1284,-0.5,"/Volumes/Drive/Thesis/new_data/sub28/log_files/sub28_S2_ASTrain.xls"
"1628","25","97",-0.5,51,19,34,2,630,488531,490028,491426,496416,497046,24103,300,630,-0.5,"/Volumes/Drive/Thesis/new_data/sub28/log_files/sub28_S2_ASTrain.xls"
"1629","26","93",-0.5,68,37,21,2,875,508542,510039,511436,515827,516702,24103,-300,875,0.5,"/Volumes/Drive/Thesis/new_data/sub28/log_files/sub28_S2_ASTrain.xls"
"1630","27","17",0.5,62,14,78,2,959,527338,528835,530232,534524,535483,24103,-400,959,0.5,"/Volumes/Drive/Thesis/new_data/sub28/log_files/sub28_S2_ASTrain.xls"
"1631","28","11",0.5,61,17,76,2,1526,545934,547431,548829,553420,554946,24103,-100,1526,-0.5,"/Volumes/Drive/Thesis/new_data/sub28/log_files/sub28_S2_ASTrain.xls"
"1632","29","38",0.5,39,25,74,1,1195,564830,566327,567725,572615,573810,24103,200,1195,-0.5,"/Volumes/Drive/Thesis/new_data/sub28/log_files/sub28_S2_ASTrain.xls"
"1633","30","123",-0.5,62,13,59,2,1015,584126,585623,587020,591810,592825,24103,100,1015,0.5,"/Volumes/Drive/Thesis/new_data/sub28/log_files/sub28_S2_ASTrain.xls"
"1634","31","67",-0.5,47,13,24,2,893,603637,605134,606531,611322,612215,24103,100,893,-0.5,"/Volumes/Drive/Thesis/new_data/sub28/log_files/sub28_S2_ASTrain.xls"
"1635","32","63",0.5,47,24,61,2,707,623232,624729,626126,630617,631324,24103,-200,707,0.5,"/Volumes/Drive/Thesis/new_data/sub28/log_files/sub28_S2_ASTrain.xls"
"1636","34","1",0.5,51,23,64,2,871,696753,698250,699647,704138,705009,677262,-200,871,-0.5,"/Volumes/Drive/Thesis/new_data/sub28/log_files/sub28_S2_ASTrain.xls"
"1637","35","55",0.5,36,28,74,1,1480,715965,717462,718859,723966,725446,677262,400,1480,0.5,"/Volumes/Drive/Thesis/new_data/sub28/log_files/sub28_S2_ASTrain.xls"
"1638","36","113",-0.5,82,19,65,2,1075,735726,737223,738620,743011,744086,677262,-300,1075,0.5,"/Volumes/Drive/Thesis/new_data/sub28/log_files/sub28_S2_ASTrain.xls"
"1639","37","125",-0.5,75,38,39,2,1170,755121,756618,758015,762306,763476,677262,-400,1170,0.5,"/Volumes/Drive/Thesis/new_data/sub28/log_files/sub28_S2_ASTrain.xls"
"1640","38","64",0.5,38,14,62,1,811,774133,775630,777027,781618,782429,677262,-100,811,0.5,"/Volumes/Drive/Thesis/new_data/sub28/log_files/sub28_S2_ASTrain.xls"
"1641","39","32",0.5,47,21,78,1,925,793029,794559,795957,800847,801772,677262,200,925,0.5,"/Volumes/Drive/Thesis/new_data/sub28/log_files/sub28_S2_ASTrain.xls"
"1642","40","94",-0.5,86,35,61,1,1360,812158,813655,815052,819443,820803,677262,-300,1360,0.5,"/Volumes/Drive/Thesis/new_data/sub28/log_files/sub28_S2_ASTrain.xls"
"1643","41","76",-0.5,53,21,34,1,1255,831054,832551,833948,838938,840193,677262,300,1255,-0.5,"/Volumes/Drive/Thesis/new_data/sub28/log_files/sub28_S2_ASTrain.xls"
"1644","42","74",-0.5,63,12,41,1,986,850249,851746,853143,858034,859020,677262,200,986,-0.5,"/Volumes/Drive/Thesis/new_data/sub28/log_files/sub28_S2_ASTrain.xls"
"1645","43","39",0.5,48,27,73,2,1345,869561,871058,872455,876847,878192,677262,-300,1345,-0.5,"/Volumes/Drive/Thesis/new_data/sub28/log_files/sub28_S2_ASTrain.xls"
"1646","44","119",-0.5,54,17,27,2,771,888457,889954,891351,895842,896613,677262,-200,771,0.5,"/Volumes/Drive/Thesis/new_data/sub28/log_files/sub28_S2_ASTrain.xls"
"1647","46","59",0.5,43,28,81,2,647,927480,928977,930374,935481,936128,677262,400,647,0.5,"/Volumes/Drive/Thesis/new_data/sub28/log_files/sub28_S2_ASTrain.xls"
"1648","47","7",0.5,42,34,78,2,1091,947507,949004,950401,955192,956283,677262,100,1091,-0.5,"/Volumes/Drive/Thesis/new_data/sub28/log_files/sub28_S2_ASTrain.xls"
"1649","48","69",-0.5,78,31,45,2,1214,966503,968000,969397,974287,975501,677262,200,1214,-0.5,"/Volumes/Drive/Thesis/new_data/sub28/log_files/sub28_S2_ASTrain.xls"
"1650","50","78",-0.5,79,36,53,1,1243,1006024,1007521,1008919,1013210,1014453,677262,-400,1243,-0.5,"/Volumes/Drive/Thesis/new_data/sub28/log_files/sub28_S2_ASTrain.xls"
"1651","51","106",-0.5,52,13,37,2,1488,1025120,1026617,1028014,1032605,1034093,677262,-100,1488,-0.5,"/Volumes/Drive/Thesis/new_data/sub28/log_files/sub28_S2_ASTrain.xls"
"1652","52","41",0.5,54,17,81,2,1624,1044631,1046128,1047526,1052516,1054140,677262,300,1624,-0.5,"/Volumes/Drive/Thesis/new_data/sub28/log_files/sub28_S2_ASTrain.xls"
"1653","54","107",-0.5,81,13,78,1,1133,1083721,1085218,1086615,1091006,1092139,677262,-300,1133,-0.5,"/Volumes/Drive/Thesis/new_data/sub28/log_files/sub28_S2_ASTrain.xls"
"1654","55","6",0.5,52,13,67,1,1119,1102633,1104130,1105528,1110019,1111138,677262,-200,1119,-0.5,"/Volumes/Drive/Thesis/new_data/sub28/log_files/sub28_S2_ASTrain.xls"
"1655","56","92",-0.5,83,21,64,1,1235,1121546,1123043,1124440,1129231,1130466,677262,100,1235,0.5,"/Volumes/Drive/Thesis/new_data/sub28/log_files/sub28_S2_ASTrain.xls"
"1656","57","47",0.5,49,23,62,1,1235,1141057,1142554,1143950,1148543,1149778,677262,-100,1235,-0.5,"/Volumes/Drive/Thesis/new_data/sub28/log_files/sub28_S2_ASTrain.xls"
"1657","58","84",-0.5,89,41,46,2,1605,1160669,1162166,1163563,1168453,1170058,677262,200,1605,0.5,"/Volumes/Drive/Thesis/new_data/sub28/log_files/sub28_S2_ASTrain.xls"
"1658","59","124",-0.5,72,24,38,2,1613,1180479,1181976,1183374,1188164,1189777,677262,100,1613,0.5,"/Volumes/Drive/Thesis/new_data/sub28/log_files/sub28_S2_ASTrain.xls"
"1659","60","26",0.5,31,28,69,1,985,1200091,1201588,1202985,1207775,1208760,677262,100,985,0.5,"/Volumes/Drive/Thesis/new_data/sub28/log_files/sub28_S2_ASTrain.xls"
"1660","61","82",-0.5,48,14,32,1,1543,1219203,1220700,1222097,1226389,1227932,677262,-400,1543,0.5,"/Volumes/Drive/Thesis/new_data/sub28/log_files/sub28_S2_ASTrain.xls"
"1661","62","108",-0.5,72,23,39,2,1372,1238498,1239995,1241392,1245684,1247056,677262,-400,1372,-0.5,"/Volumes/Drive/Thesis/new_data/sub28/log_files/sub28_S2_ASTrain.xls"
"1662","63","2",0.5,41,23,74,1,904,1257095,1258592,1259989,1264480,1265384,677262,-200,904,-0.5,"/Volumes/Drive/Thesis/new_data/sub28/log_files/sub28_S2_ASTrain.xls"
"1663","64","48",0.5,49,24,71,1,1672,1276007,1277504,1278901,1283492,1285164,677262,-100,1672,-0.5,"/Volumes/Drive/Thesis/new_data/sub28/log_files/sub28_S2_ASTrain.xls"
"1664","65","53",0.5,57,16,75,2,1356,1404370,1405867,1407264,1412055,1413411,1404179,100,1356,0.5,"/Volumes/Drive/Thesis/new_data/sub28/log_files/sub28_S2_ASTrain.xls"
"1665","66","10",0.5,42,37,69,1,1279,1423565,1425062,1426460,1431350,1432629,1404179,200,1279,-0.5,"/Volumes/Drive/Thesis/new_data/sub28/log_files/sub28_S2_ASTrain.xls"
"1666","67","127",-0.5,65,27,48,1,1016,1442661,1444158,1445555,1449847,1450863,1404179,-400,1016,0.5,"/Volumes/Drive/Thesis/new_data/sub28/log_files/sub28_S2_ASTrain.xls"
"1667","69","43",0.5,43,19,64,2,1003,1481467,1482964,1484362,1489468,1490471,1404179,400,1003,-0.5,"/Volumes/Drive/Thesis/new_data/sub28/log_files/sub28_S2_ASTrain.xls"
"1668","70","51",0.5,37,25,72,2,1219,1500896,1502393,1503790,1508580,1509799,1404179,100,1219,0.5,"/Volumes/Drive/Thesis/new_data/sub28/log_files/sub28_S2_ASTrain.xls"
"1669","71","40",0.5,67,15,84,2,1325,1520706,1522204,1523601,1528707,1530032,1404179,400,1325,-0.5,"/Volumes/Drive/Thesis/new_data/sub28/log_files/sub28_S2_ASTrain.xls"
"1670","72","109",-0.5,75,26,47,1,1329,1540717,1542214,1543611,1548718,1550047,1404179,400,1329,-0.5,"/Volumes/Drive/Thesis/new_data/sub28/log_files/sub28_S2_ASTrain.xls"
"1671","73","126",-0.5,87,38,47,1,1342,1560844,1562341,1563738,1568845,1570187,1404179,400,1342,0.5,"/Volumes/Drive/Thesis/new_data/sub28/log_files/sub28_S2_ASTrain.xls"
"1672","74","68",-0.5,46,14,34,1,1000,1580854,1582351,1583748,1588156,1589156,1404179,-300,1000,-0.5,"/Volumes/Drive/Thesis/new_data/sub28/log_files/sub28_S2_ASTrain.xls"
"1673","75","90",-0.5,74,43,41,1,1074,1599484,1600981,1602378,1607269,1608343,1404179,200,1074,0.5,"/Volumes/Drive/Thesis/new_data/sub28/log_files/sub28_S2_ASTrain.xls"
"1674","76","4",0.5,53,21,76,1,819,1619178,1620675,1622073,1626664,1627483,1404179,-100,819,-0.5,"/Volumes/Drive/Thesis/new_data/sub28/log_files/sub28_S2_ASTrain.xls"
"1675","77","30",0.5,46,32,68,1,679,1638590,1640087,1641484,1645975,1646654,1404179,-200,679,0.5,"/Volumes/Drive/Thesis/new_data/sub28/log_files/sub28_S2_ASTrain.xls"
"1676","78","45",0.5,48,24,82,2,857,1657486,1658983,1660380,1665171,1666028,1404179,100,857,-0.5,"/Volumes/Drive/Thesis/new_data/sub28/log_files/sub28_S2_ASTrain.xls"
"1677","79","121",-0.5,61,24,39,2,1098,1676681,1678178,1679576,1683867,1684965,1404179,-400,1098,0.5,"/Volumes/Drive/Thesis/new_data/sub28/log_files/sub28_S2_ASTrain.xls"
"1678","80","34",0.5,37,28,67,2,1680,1695993,1697490,1698887,1703379,1705059,1404179,-200,1680,-0.5,"/Volumes/Drive/Thesis/new_data/sub28/log_files/sub28_S2_ASTrain.xls"
"1679","81","16",0.5,45,34,89,1,995,1714706,1716203,1717600,1722391,1723386,1404179,100,995,-0.5,"/Volumes/Drive/Thesis/new_data/sub28/log_files/sub28_S2_ASTrain.xls"
"1680","83","49",0.5,39,17,58,1,849,1753113,1754611,1756008,1760599,1761448,1404179,-100,849,0.5,"/Volumes/Drive/Thesis/new_data/sub28/log_files/sub28_S2_ASTrain.xls"
"1681","84","77",-0.5,86,25,71,2,1084,1772026,1773523,1774920,1779910,1780994,1404179,300,1084,-0.5,"/Volumes/Drive/Thesis/new_data/sub28/log_files/sub28_S2_ASTrain.xls"
"1682","85","18",0.5,32,13,47,1,1062,1791538,1793035,1794432,1799322,1800384,1404179,200,1062,0.5,"/Volumes/Drive/Thesis/new_data/sub28/log_files/sub28_S2_ASTrain.xls"
"1683","86","13",0.5,58,21,69,2,978,1810932,1812430,1813827,1818218,1819196,1404179,-300,978,-0.5,"/Volumes/Drive/Thesis/new_data/sub28/log_files/sub28_S2_ASTrain.xls"
"1684","88","81",-0.5,76,24,54,2,1080,1849423,1850920,1852317,1856709,1857789,1404179,-300,1080,0.5,"/Volumes/Drive/Thesis/new_data/sub28/log_files/sub28_S2_ASTrain.xls"
"1685","89","95",-0.5,68,15,51,2,1152,1868236,1869733,1871130,1876120,1877272,1404179,300,1152,0.5,"/Volumes/Drive/Thesis/new_data/sub28/log_files/sub28_S2_ASTrain.xls"
"1686","90","71",-0.5,67,14,51,2,911,1887548,1889045,1890442,1895033,1895944,1404179,-100,911,-0.5,"/Volumes/Drive/Thesis/new_data/sub28/log_files/sub28_S2_ASTrain.xls"
"1687","91","96",-0.5,56,15,31,2,1380,1906444,1907941,1909338,1913829,1915209,1404179,-200,1380,0.5,"/Volumes/Drive/Thesis/new_data/sub28/log_files/sub28_S2_ASTrain.xls"
"1688","92","98",-0.5,62,28,32,1,1235,1925955,1927452,1928849,1933739,1934974,1404179,200,1235,-0.5,"/Volumes/Drive/Thesis/new_data/sub28/log_files/sub28_S2_ASTrain.xls"
"1689","93","20",0.5,51,24,65,1,724,1945067,1946564,1947961,1952952,1953676,1404179,300,724,0.5,"/Volumes/Drive/Thesis/new_data/sub28/log_files/sub28_S2_ASTrain.xls"
"1690","94","101",-0.5,64,18,48,1,1207,1964861,1966358,1967756,1972047,1973254,1404179,-400,1207,-0.5,"/Volumes/Drive/Thesis/new_data/sub28/log_files/sub28_S2_ASTrain.xls"
"1691","95","22",0.5,31,23,56,1,1083,1983857,1985354,1986751,1991342,1992425,1404179,-100,1083,0.5,"/Volumes/Drive/Thesis/new_data/sub28/log_files/sub28_S2_ASTrain.xls"
"1692","96","73",-0.5,83,51,34,2,1261,2003369,2004866,2006263,2010554,2011815,1404179,-400,1261,-0.5,"/Volumes/Drive/Thesis/new_data/sub28/log_files/sub28_S2_ASTrain.xls"
"1693","97","72",-0.5,79,21,68,1,837,2059990,2061487,2062884,2067774,2068611,2059830,200,837,-0.5,"/Volumes/Drive/Thesis/new_data/sub28/log_files/sub28_S2_ASTrain.xls"
"1694","98","27",0.5,41,17,56,2,1146,2079701,2081198,2082595,2087386,2088532,2059830,100,1146,0.5,"/Volumes/Drive/Thesis/new_data/sub28/log_files/sub28_S2_ASTrain.xls"
"1695","99","56",0.5,58,17,65,1,771,2099512,2101009,2102406,2106698,2107469,2059830,-400,771,0.5,"/Volumes/Drive/Thesis/new_data/sub28/log_files/sub28_S2_ASTrain.xls"
"1696","100","12",0.5,62,16,68,1,975,2118225,2119722,2121119,2126009,2126984,2059830,200,975,-0.5,"/Volumes/Drive/Thesis/new_data/sub28/log_files/sub28_S2_ASTrain.xls"
"1697","102","35",0.5,36,17,63,2,1204,2157464,2158961,2160358,2165248,2166452,2059830,200,1204,-0.5,"/Volumes/Drive/Thesis/new_data/sub28/log_files/sub28_S2_ASTrain.xls"
"1698","103","42",0.5,52,19,61,2,1199,2176676,2178173,2179570,2184361,2185560,2059830,100,1199,-0.5,"/Volumes/Drive/Thesis/new_data/sub28/log_files/sub28_S2_ASTrain.xls"
"1699","104","8",0.5,24,13,47,2,1418,2195688,2197185,2198582,2203689,2205107,2059830,400,1418,-0.5,"/Volumes/Drive/Thesis/new_data/sub28/log_files/sub28_S2_ASTrain.xls"
"1700","105","91",-0.5,74,42,42,2,861,2215216,2216713,2218110,2222901,2223762,2059830,100,861,0.5,"/Volumes/Drive/Thesis/new_data/sub28/log_files/sub28_S2_ASTrain.xls"
"1701","106","86",-0.5,75,13,64,1,893,2234412,2235909,2237306,2241697,2242590,2059830,-300,893,0.5,"/Volumes/Drive/Thesis/new_data/sub28/log_files/sub28_S2_ASTrain.xls"
"1702","107","117",-0.5,72,29,41,2,381,2253008,2254505,2255902,2260693,2261074,2059830,100,381,0.5,"/Volumes/Drive/Thesis/new_data/sub28/log_files/sub28_S2_ASTrain.xls"
"1703","108","103",-0.5,73,15,68,2,1025,2272719,2274216,2275613,2280720,2281745,2059830,400,1025,-0.5,"/Volumes/Drive/Thesis/new_data/sub28/log_files/sub28_S2_ASTrain.xls"
"1704","109","100",-0.5,74,35,49,1,1120,2292131,2293628,2295025,2300015,2301135,2059830,300,1120,-0.5,"/Volumes/Drive/Thesis/new_data/sub28/log_files/sub28_S2_ASTrain.xls"
"1705","110","60",0.5,34,29,53,1,1223,2312141,2313638,2315035,2319427,2320650,2059830,-300,1223,0.5,"/Volumes/Drive/Thesis/new_data/sub28/log_files/sub28_S2_ASTrain.xls"
"1706","111","80",-0.5,59,18,31,1,787,2331237,2332734,2334131,2339238,2340025,2059830,400,787,-0.5,"/Volumes/Drive/Thesis/new_data/sub28/log_files/sub28_S2_ASTrain.xls"
"1707","112","83",-0.5,48,23,23,2,1069,2351064,2352561,2353958,2358549,2359618,2059830,-100,1069,0.5,"/Volumes/Drive/Thesis/new_data/sub28/log_files/sub28_S2_ASTrain.xls"
"1708","113","37",0.5,46,28,64,2,1312,2370176,2371673,2373071,2377462,2378774,2059830,-300,1312,-0.5,"/Volumes/Drive/Thesis/new_data/sub28/log_files/sub28_S2_ASTrain.xls"
"1709","114","115",-0.5,64,25,29,2,1041,2389472,2390969,2392366,2396857,2397898,2059830,-200,1041,0.5,"/Volumes/Drive/Thesis/new_data/sub28/log_files/sub28_S2_ASTrain.xls"
"1710","115","122",-0.5,52,14,36,1,973,2408368,2409865,2411262,2415753,2416726,2059830,-200,973,0.5,"/Volumes/Drive/Thesis/new_data/sub28/log_files/sub28_S2_ASTrain.xls"
"1711","116","65",-0.5,68,12,54,2,932,2427779,2429276,2430673,2434965,2435897,2059830,-400,932,-0.5,"/Volumes/Drive/Thesis/new_data/sub28/log_files/sub28_S2_ASTrain.xls"
"1712","117","85",-0.5,65,24,43,2,640,2446293,2447790,2449187,2453678,2454318,2059830,-200,640,0.5,"/Volumes/Drive/Thesis/new_data/sub28/log_files/sub28_S2_ASTrain.xls"
"1713","118","19",0.5,34,23,67,2,984,2465604,2467101,2468499,2472990,2473974,2059830,-200,984,0.5,"/Volumes/Drive/Thesis/new_data/sub28/log_files/sub28_S2_ASTrain.xls"
"1714","119","9",0.5,24,15,37,2,638,2485116,2486613,2488010,2492601,2493239,2059830,-100,638,-0.5,"/Volumes/Drive/Thesis/new_data/sub28/log_files/sub28_S2_ASTrain.xls"
"1715","120","61",0.5,39,24,61,2,521,2504028,2505525,2506923,2511514,2512035,2059830,-100,521,0.5,"/Volumes/Drive/Thesis/new_data/sub28/log_files/sub28_S2_ASTrain.xls"
"1716","121","21",0.5,41,34,73,2,575,2523440,2524937,2526334,2531225,2531800,2059830,200,575,0.5,"/Volumes/Drive/Thesis/new_data/sub28/log_files/sub28_S2_ASTrain.xls"
"1717","122","120",-0.5,71,35,46,1,935,2542534,2544033,2545430,2550021,2550956,2059830,-100,935,0.5,"/Volumes/Drive/Thesis/new_data/sub28/log_files/sub28_S2_ASTrain.xls"
"1718","123","99",-0.5,83,25,48,2,1227,2562147,2563644,2565041,2569432,2570659,2059830,-300,1227,-0.5,"/Volumes/Drive/Thesis/new_data/sub28/log_files/sub28_S2_ASTrain.xls"
"1719","124","50",0.5,49,25,72,2,689,2581409,2582906,2584303,2588594,2589283,2059830,-400,689,0.5,"/Volumes/Drive/Thesis/new_data/sub28/log_files/sub28_S2_ASTrain.xls"
"1720","125","66",-0.5,86,41,43,2,1313,2600221,2601718,2603116,2607407,2608720,2059830,-400,1313,-0.5,"/Volumes/Drive/Thesis/new_data/sub28/log_files/sub28_S2_ASTrain.xls"
"1721","126","111",-0.5,65,29,38,2,1120,2619433,2620930,2622328,2627318,2628438,2059830,300,1120,-0.5,"/Volumes/Drive/Thesis/new_data/sub28/log_files/sub28_S2_ASTrain.xls"
"1722","127","14",0.5,48,21,71,1,984,2638945,2640442,2641839,2646829,2647813,2059830,300,984,-0.5,"/Volumes/Drive/Thesis/new_data/sub28/log_files/sub28_S2_ASTrain.xls"
"1723","128","33",0.5,58,16,72,2,616,2658656,2660153,2661550,2666540,2667156,2059830,300,616,-0.5,"/Volumes/Drive/Thesis/new_data/sub28/log_files/sub28_S2_ASTrain.xls"
